Team,G,MP,FG,FGA,FG%,3P,3PA,3P%,2P,2PA,2P%,FT,FTA,FT%,ORB,DRB,TRB,AST,STL,BLK,TOV,PF,PTS,Season
SACRAMENTO KINGS,82,19805,3276,7288,.450,534,1656,.322,2742,5632,.487,1521,2016,.754,1056,2635,3691,1953,787,381,1325,1729,8607,1999-2000
DETROIT PISTONS,82,19830,3044,6635,.459,439,1223,.359,2605,5412,.481,1956,2506,.781,917,2458,3375,1707,665,273,1288,2011,8483,1999-2000
DALLAS MAVERICKS,82,19730,3195,7047,.453,519,1326,.391,2676,5721,.468,1407,1751,.804,931,2444,3375,1810,592,416,1124,1770,8316,1999-2000
INDIANA PACERS,82,19730,3047,6640,.459,583,1487,.392,2464,5153,.478,1629,2008,.811,842,2612,3454,1857,559,422,1159,1786,8306,1999-2000
MILWAUKEE BUCKS,82,19855,3174,6827,.465,394,1069,.369,2780,5758,.483,1558,1982,.786,1016,2373,3389,1852,671,381,1230,2020,8300,1999-2000
LOS ANGELES LAKERS,82,19805,3137,6836,.459,344,1047,.329,2793,5789,.482,1649,2368,.696,1117,2738,3855,1921,613,534,1143,1841,8267,1999-2000
ORLANDO MAGIC,82,19755,3169,7014,.452,294,870,.338,2875,6144,.468,1574,2142,.735,1145,2540,3685,1709,743,467,1443,1967,8206,1999-2000
HOUSTON ROCKETS,82,19830,3001,6664,.450,581,1625,.358,2420,5039,.480,1573,2145,.733,1008,2586,3594,1774,613,438,1425,1663,8156,1999-2000
BOSTON CELTICS,82,19730,3054,6880,.444,417,1260,.331,2637,5620,.469,1621,2175,.745,1108,2420,3528,1741,795,286,1259,2223,8146,1999-2000
SEATTLE SUPERSONICS,82,19780,3108,6946,.447,546,1611,.339,2562,5335,.480,1363,1960,.695,1042,2483,3525,1878,657,345,1152,1776,8125,1999-2000
DENVER NUGGETS,82,19855,3057,6911,.442,470,1397,.336,2587,5514,.469,1531,2116,.724,1073,2590,3663,1911,554,618,1281,1962,8115,1999-2000
PHOENIX SUNS,82,19805,3093,6771,.457,458,1246,.368,2635,5525,.477,1467,1934,.759,1022,2558,3580,2098,744,433,1368,1973,8111,1999-2000
MINNESOTA TIMBERWOLVES,82,19905,3226,6910,.467,248,716,.346,2978,6194,.481,1379,1769,.780,1016,2471,3487,2205,622,444,1139,1913,8079,1999-2000
CHARLOTTE HORNETS,82,19780,2935,6533,.449,339,1001,.339,2596,5532,.469,1863,2458,.758,884,2635,3519,2023,732,480,1206,1670,8072,1999-2000
NEW JERSEY NETS,82,19830,2979,6881,.433,477,1374,.347,2502,5507,.454,1601,2041,.784,1040,2315,3355,1688,720,393,1119,1913,8036,1999-2000
PORTLAND TRAIL BLAZERS,82,19780,3021,6430,.470,407,1128,.361,2614,5302,.493,1542,2029,.760,966,2560,3526,1925,633,396,1243,1865,7991,1999-2000
TORONTO RAPTORS,82,19755,2980,6882,.433,425,1171,.363,2555,5711,.447,1583,2068,.765,1098,2449,3547,1947,666,544,1137,1989,7968,1999-2000
CLEVELAND CAVALIERS,82,19855,2977,6734,.442,343,919,.373,2634,5815,.453,1653,2205,.750,1010,2499,3509,1941,715,363,1427,2219,7950,1999-2000
WASHINGTON WIZARDS,82,19805,3010,6681,.451,335,890,.376,2675,5791,.462,1566,2107,.743,1064,2438,3502,1771,593,383,1320,2149,7921,1999-2000
UTAH JAZZ,82,19755,2962,6380,.464,329,854,.385,2633,5526,.476,1661,2150,.773,936,2426,3362,2041,629,446,1220,2013,7914,1999-2000
SAN ANTONIO SPURS,82,19855,2952,6393,.462,330,882,.374,2622,5511,.476,1652,2214,.746,927,2666,3593,1819,614,551,1233,1716,7886,1999-2000
GOLDEN STATE WARRIORS,82,19755,2996,7140,.420,345,1069,.323,2651,6071,.437,1497,2147,.697,1300,2438,3738,1851,731,356,1302,2043,7834,1999-2000
PHILADELPHIA 76ERS,82,19830,2993,6776,.442,208,643,.323,2785,6133,.454,1577,2226,.708,1147,2468,3615,1817,791,386,1284,1939,7771,1999-2000
MIAMI HEAT,82,19830,2974,6462,.460,446,1202,.371,2528,5260,.481,1345,1827,.736,921,2619,3540,1931,582,524,1231,1947,7739,1999-2000
ATLANTA HAWKS,82,19830,3000,6807,.441,258,814,.317,2742,5993,.458,1477,1987,.743,1146,2570,3716,1548,500,461,1266,1718,7735,1999-2000
VANCOUVER GRIZZLIES,82,19855,2892,6441,.449,324,898,.361,2568,5543,.463,1594,2060,.774,1005,2324,3329,1700,608,346,1381,1881,7702,1999-2000
NEW YORK KNICKS,82,19830,2897,6374,.455,351,937,.375,2546,5437,.468,1410,1805,.781,802,2521,3323,1588,515,349,1201,1983,7555,1999-2000
LOS ANGELES CLIPPERS,82,19705,2877,6757,.426,429,1267,.339,2448,5490,.446,1363,1826,.746,955,2377,3332,1479,578,494,1325,1821,7546,1999-2000
CHICAGO BULLS,82,19805,2565,6180,.415,340,1032,.329,2225,5148,.432,1482,2089,.709,1032,2323,3355,1645,646,383,1557,1908,6952,1999-2000
SACRAMENTO KINGS,82,20080,3132,6969,.449,479,1353,.354,2653,5616,.472,1600,2075,.771,987,2705,3692,1852,793,432,1221,1596,8343,2000-2001
MILWAUKEE BUCKS,82,19780,3112,6798,.458,562,1481,.379,2550,5317,.480,1474,1874,.787,975,2500,3475,1844,672,386,1123,1928,8260,2000-2001
LOS ANGELES LAKERS,82,19905,3109,6685,.465,439,1275,.344,2670,5410,.494,1594,2333,.683,1085,2583,3668,1888,564,490,1184,1872,8251,2000-2001
DALLAS MAVERICKS,82,19805,3085,6716,.459,517,1357,.381,2568,5359,.479,1552,1954,.794,831,2571,3402,1740,618,492,1141,1907,8239,2000-2001
TORONTO RAPTORS,82,19955,3048,6972,.437,429,1164,.369,2619,5808,.451,1482,1984,.747,1118,2529,3647,2004,599,519,1080,1745,8007,2000-2001
ORLANDO MAGIC,82,19955,3013,6873,.438,490,1346,.364,2523,5527,.456,1476,2068,.714,1069,2450,3519,1803,674,481,1245,2071,7992,2000-2001
MINNESOTA TIMBERWOLVES,82,19830,3148,6871,.458,322,901,.357,2826,5970,.473,1364,1737,.785,1002,2470,3472,2083,682,456,1136,1900,7982,2000-2001
SEATTLE SUPERSONICS,82,19805,3029,6649,.456,466,1169,.399,2563,5480,.468,1454,1986,.732,999,2422,3421,1792,657,409,1252,1733,7978,2000-2001
HOUSTON ROCKETS,82,19830,2943,6494,.453,504,1412,.357,2439,5082,.480,1582,2086,.758,919,2524,3443,1613,587,358,1204,1657,7972,2000-2001
UTAH JAZZ,82,19780,2960,6289,.471,325,852,.381,2635,5437,.485,1714,2280,.752,943,2383,3326,2110,661,463,1296,2107,7959,2000-2001
DENVER NUGGETS,82,19780,2979,6877,.433,512,1444,.355,2467,5433,.454,1448,1964,.737,1044,2583,3627,1970,552,538,1136,1820,7918,2000-2001
SAN ANTONIO SPURS,82,19830,2884,6262,.461,445,1094,.407,2439,5168,.472,1673,2340,.715,902,2712,3614,1778,568,576,1145,1551,7886,2000-2001
DETROIT PISTONS,82,19855,2919,6880,.424,389,1112,.350,2530,5768,.439,1610,2233,.721,1108,2626,3734,1629,613,447,1304,1955,7837,2000-2001
PORTLAND TRAIL BLAZERS,82,19780,3004,6417,.468,369,1057,.349,2635,5360,.492,1447,1899,.762,960,2481,3441,1963,672,419,1257,1745,7824,2000-2001
PHILADELPHIA 76ERS,82,19855,2902,6487,.447,262,803,.326,2640,5684,.464,1697,2277,.745,1075,2600,3675,1692,690,408,1292,1673,7763,2000-2001
BOSTON CELTICS,82,19830,2773,6485,.428,592,1633,.363,2181,4852,.450,1621,2190,.740,897,2367,3264,1708,769,336,1285,1952,7759,2000-2001
PHOENIX SUNS,82,19805,2944,6757,.436,332,1054,.315,2612,5703,.458,1490,1973,.755,970,2529,3499,1905,775,429,1250,1864,7710,2000-2001
WASHINGTON WIZARDS,82,19680,2833,6453,.439,275,848,.324,2558,5605,.456,1704,2245,.759,1016,2370,3386,1647,630,383,1391,1913,7645,2000-2001
INDIANA PACERS,82,19980,2828,6431,.440,396,1159,.342,2432,5272,.461,1539,2009,.766,921,2595,3516,1763,563,487,1244,1926,7591,2000-2001
GOLDEN STATE WARRIORS,82,19780,2937,7175,.409,282,964,.293,2655,6211,.427,1428,2024,.706,1345,2385,3730,1788,742,410,1301,1727,7584,2000-2001
LOS ANGELES CLIPPERS,82,20030,2896,6467,.448,360,1063,.339,2536,5404,.469,1429,2061,.693,962,2559,3521,1585,490,513,1293,1775,7581,2000-2001
CLEVELAND CAVALIERS,82,19830,2890,6532,.442,220,659,.334,2670,5873,.455,1561,2040,.765,1015,2440,3455,1708,642,436,1350,1904,7561,2000-2001
NEW JERSEY NETS,82,19730,2781,6550,.425,361,1084,.333,2420,5466,.443,1629,2146,.759,909,2337,3246,1603,649,407,1208,1982,7552,2000-2001
CHARLOTTE HORNETS,82,19880,2800,6501,.431,340,984,.346,2460,5517,.446,1599,2146,.745,1033,2608,3641,1900,665,455,1183,1753,7539,2000-2001
VANCOUVER GRIZZLIES,82,19780,2870,6539,.439,325,947,.343,2545,5592,.455,1457,1892,.770,894,2431,3325,1899,586,359,1291,1733,7522,2000-2001
ATLANTA HAWKS,82,19730,2876,6668,.431,333,933,.357,2543,5735,.443,1374,1811,.759,1028,2490,3518,1559,634,387,1368,1863,7459,2000-2001
MIAMI HEAT,82,19880,2694,6258,.430,478,1384,.345,2216,4874,.455,1423,1874,.759,813,2435,3248,1630,633,304,1122,1726,7289,2000-2001
NEW YORK KNICKS,82,19905,2755,6198,.444,391,1115,.351,2364,5083,.465,1374,1727,.796,773,2524,3297,1520,545,346,1189,1863,7275,2000-2001
CHICAGO BULLS,82,19855,2721,6411,.424,329,950,.346,2392,5461,.438,1410,1909,.739,926,2260,3186,1810,675,379,1292,1902,7181,2000-2001
DALLAS MAVERICKS,82,19880,3200,6930,.462,621,1645,.378,2579,5285,.488,1608,1994,.806,918,2568,3486,1811,581,392,992,1842,8629,2001-2002
SACRAMENTO KINGS,82,19755,3267,7003,.467,426,1160,.367,2841,5843,.486,1618,2154,.751,1013,2702,3715,1958,741,375,1128,1560,8578,2001-2002
LOS ANGELES LAKERS,82,19780,3150,6840,.461,510,1439,.354,2640,5401,.489,1494,2138,.699,1022,2607,3629,1882,625,478,1040,1823,8304,2001-2002
ORLANDO MAGIC,82,19830,3087,6893,.448,620,1660,.373,2467,5233,.471,1446,1917,.754,942,2440,3382,1804,665,384,1119,1700,8240,2001-2002
MINNESOTA TIMBERWOLVES,82,19805,3175,6887,.461,396,1047,.378,2779,5840,.476,1399,1754,.798,1059,2562,3621,1993,524,427,1097,1739,8145,2001-2002
SEATTLE SUPERSONICS,82,19830,3131,6681,.469,489,1292,.378,2642,5389,.490,1263,1672,.755,968,2333,3301,1926,698,364,1124,1732,8014,2001-2002
GOLDEN STATE WARRIORS,82,19780,2998,6989,.429,320,994,.322,2678,5995,.447,1693,2344,.722,1334,2493,3827,1706,650,523,1378,1884,8009,2001-2002
MILWAUKEE BUCKS,82,19905,3041,6577,.462,593,1583,.375,2448,4994,.490,1321,1767,.748,841,2557,3398,1847,596,388,1157,1788,7996,2001-2002
INDIANA PACERS,82,19905,2935,6580,.446,405,1195,.339,2530,5385,.470,1663,2155,.772,930,2568,3498,1884,658,436,1249,1876,7938,2001-2002
SAN ANTONIO SPURS,82,19855,2913,6363,.458,438,1211,.362,2475,5152,.480,1668,2249,.742,907,2566,3473,1643,625,537,1180,1575,7932,2001-2002
PORTLAND TRAIL BLAZERS,82,19830,3004,6671,.450,466,1318,.354,2538,5353,.474,1451,1901,.763,1085,2444,3529,1926,702,368,1172,1613,7925,2001-2002
BOSTON CELTICS,82,19830,2852,6731,.424,699,1946,.359,2153,4785,.450,1498,1960,.764,891,2570,3461,1722,793,292,1114,1776,7901,2001-2002
NEW JERSEY NETS,82,19830,3042,6816,.446,403,1194,.338,2639,5622,.469,1402,1907,.735,1039,2515,3554,1990,716,490,1189,1734,7889,2001-2002
UTAH JAZZ,82,19830,2869,6374,.450,280,842,.333,2589,5532,.468,1853,2430,.763,1109,2349,3458,1999,749,523,1353,1971,7871,2001-2002
LOS ANGELES CLIPPERS,82,19805,2970,6668,.445,408,1147,.356,2562,5521,.464,1498,2026,.739,1083,2474,3557,1714,510,540,1214,1624,7846,2001-2002
CLEVELAND CAVALIERS,82,19855,2948,6582,.448,387,1026,.377,2561,5556,.461,1529,1980,.772,968,2483,3451,1891,572,470,1196,1752,7812,2001-2002
PHOENIX SUNS,82,19830,3097,6934,.447,358,1096,.327,2739,5838,.469,1250,1630,.767,1072,2430,3502,1838,668,401,1205,1785,7802,2001-2002
DETROIT PISTONS,82,19680,2845,6300,.452,567,1509,.376,2278,4791,.475,1478,1954,.756,810,2366,3176,1765,648,565,1193,1695,7735,2001-2002
ATLANTA HAWKS,82,19780,2901,6610,.439,423,1194,.354,2478,5416,.458,1486,1942,.765,955,2445,3400,1656,667,350,1275,1702,7711,2001-2002
CHARLOTTE HORNETS,82,19755,2893,6580,.440,346,994,.348,2547,5586,.456,1568,2105,.745,1059,2505,3564,1759,653,456,1150,1747,7700,2001-2002
WASHINGTON WIZARDS,82,19730,2938,6664,.441,305,786,.388,2633,5878,.448,1428,1866,.765,1055,2393,3448,1715,570,354,1068,1763,7609,2001-2002
HOUSTON ROCKETS,82,19980,2837,6629,.428,496,1480,.335,2341,5149,.455,1402,1893,.741,1025,2411,3436,1482,537,445,1156,1476,7572,2001-2002
DENVER NUGGETS,82,19805,2915,6870,.424,423,1285,.329,2492,5585,.446,1306,1756,.744,1117,2310,3427,1817,613,462,1205,1873,7559,2001-2002
NEW YORK KNICKS,82,19805,2817,6520,.432,474,1344,.353,2343,5176,.453,1406,1786,.787,876,2458,3334,1720,558,288,1192,1800,7514,2001-2002
TORONTO RAPTORS,82,19755,2919,6727,.434,387,1109,.349,2532,5618,.451,1269,1717,.739,1114,2336,3450,1779,688,454,1174,1771,7494,2001-2002
PHILADELPHIA 76ERS,82,19730,2804,6436,.436,214,715,.299,2590,5721,.453,1639,2104,.779,1092,2534,3626,1638,705,363,1256,1645,7461,2001-2002
MEMPHIS GRIZZLIES,82,19780,2851,6535,.436,336,1096,.307,2515,5439,.462,1334,1883,.708,984,2413,3397,1785,646,488,1344,1571,7372,2001-2002
CHICAGO BULLS,82,19805,2811,6491,.433,300,868,.346,2511,5623,.447,1413,1958,.722,924,2359,3283,1817,633,361,1252,1834,7335,2001-2002
MIAMI HEAT,82,19930,2801,6382,.439,312,899,.347,2489,5483,.454,1236,1708,.724,902,2544,3446,1664,547,448,1217,1846,7150,2001-2002
DALLAS MAVERICKS,82,19780,3161,6982,.453,636,1668,.381,2525,5314,.475,1486,1793,.829,912,2544,3456,1837,665,449,949,1730,8444,2002-2003
GOLDEN STATE WARRIORS,82,19755,3061,6941,.441,425,1235,.344,2636,5706,.462,1853,2382,.778,1284,2546,3830,1712,594,506,1295,1786,8400,2002-2003
SACRAMENTO KINGS,82,19830,3242,6990,.464,491,1288,.381,2751,5702,.482,1367,1832,.746,900,2751,3651,2034,736,457,1192,1666,8342,2002-2003
LOS ANGELES LAKERS,82,19930,3091,6856,.451,486,1367,.356,2605,5489,.475,1562,2129,.734,1078,2554,3632,1909,639,470,1192,1874,8230,2002-2003
MILWAUKEE BUCKS,82,19905,3045,6670,.457,585,1526,.383,2460,5144,.478,1483,1911,.776,876,2367,3243,1823,622,344,1044,1820,8158,2002-2003
ORLANDO MAGIC,82,19805,2947,6763,.436,568,1590,.357,2379,5173,.460,1616,2079,.777,958,2392,3350,1676,696,300,1177,1888,8078,2002-2003
MINNESOTA TIMBERWOLVES,82,19805,3172,6809,.466,296,804,.368,2876,6005,.479,1406,1826,.770,959,2614,3573,2070,553,433,1124,1704,8046,2002-2003
MEMPHIS GRIZZLIES,82,19930,3049,6743,.452,467,1279,.365,2582,5464,.473,1430,1936,.739,943,2466,3409,1892,651,500,1262,1678,7995,2002-2003
PHILADELPHIA 76ERS,82,19855,2975,6640,.448,245,787,.311,2730,5853,.466,1746,2253,.775,1042,2415,3457,1771,844,284,1212,1804,7941,2002-2003
INDIANA PACERS,82,19905,2911,6608,.441,379,1119,.339,2532,5489,.461,1739,2271,.766,1004,2622,3626,1910,696,443,1210,1811,7940,2002-2003
NEW YORK KNICKS,82,19855,2967,6725,.441,606,1582,.383,2361,5143,.459,1320,1620,.815,842,2376,3218,1800,579,255,1149,1888,7860,2002-2003
SAN ANTONIO SPURS,82,19830,2908,6297,.462,449,1270,.354,2459,5027,.489,1591,2194,.725,939,2556,3495,1636,629,529,1295,1672,7856,2002-2003
PHOENIX SUNS,82,19805,3005,6776,.443,394,1149,.343,2611,5627,.464,1430,1928,.742,1049,2440,3489,1719,665,404,1208,1801,7834,2002-2003
NEW JERSEY NETS,82,19755,2906,6585,.441,346,1041,.332,2560,5544,.462,1662,2195,.757,991,2528,3519,1887,717,374,1212,1772,7820,2002-2003
PORTLAND TRAIL BLAZERS,82,19855,2987,6491,.460,379,1150,.330,2608,5341,.488,1450,1947,.745,992,2378,3370,1860,725,316,1248,1634,7803,2002-2003
CHICAGO BULLS,82,19930,2991,6714,.445,349,997,.350,2642,5717,.462,1455,2014,.722,985,2541,3526,1782,605,461,1388,2028,7786,2002-2003
UTAH JAZZ,82,19780,2894,6189,.468,224,641,.349,2670,5548,.481,1750,2349,.745,1021,2381,3402,2103,708,467,1374,1837,7762,2002-2003
ATLANTA HAWKS,82,19905,2859,6434,.444,402,1141,.352,2457,5293,.464,1594,2011,.793,937,2558,3495,1679,611,473,1367,1783,7714,2002-2003
NEW ORLEANS HORNETS,82,19905,2914,6695,.435,404,1075,.376,2510,5620,.447,1467,1910,.768,1097,2475,3572,1807,656,394,1212,1769,7699,2002-2003
LOS ANGELES CLIPPERS,82,19755,2835,6490,.437,390,1178,.331,2445,5312,.460,1633,2177,.750,1008,2462,3470,1605,574,461,1291,1784,7693,2002-2003
HOUSTON ROCKETS,82,19930,2840,6461,.440,439,1267,.346,2401,5194,.462,1569,2044,.768,1024,2564,3588,1506,594,493,1276,1602,7688,2002-2003
BOSTON CELTICS,82,19830,2700,6509,.415,719,2155,.334,1981,4354,.455,1480,1994,.742,849,2471,3320,1575,720,303,1147,1758,7599,2002-2003
SEATTLE SUPERSONICS,82,19855,2887,6599,.437,456,1291,.353,2431,5308,.458,1325,1780,.744,963,2385,3348,1775,679,295,1085,1712,7555,2002-2003
WASHINGTON WIZARDS,82,19830,2816,6394,.440,253,811,.312,2563,5583,.459,1617,2077,.779,917,2395,3312,1612,621,390,1095,1644,7502,2002-2003
CLEVELAND CAVALIERS,82,19830,2850,6746,.422,293,896,.327,2557,5850,.437,1502,2012,.747,1118,2542,3660,1712,636,521,1501,1864,7495,2002-2003
DETROIT PISTONS,82,19905,2700,6277,.430,533,1488,.358,2167,4789,.452,1559,2021,.771,883,2445,3328,1620,556,468,1104,1748,7492,2002-2003
TORONTO RAPTORS,82,19805,2847,6664,.427,409,1193,.343,2438,5471,.446,1350,1879,.718,1023,2355,3378,1583,609,392,1181,1761,7453,2002-2003
MIAMI HEAT,82,19830,2688,6517,.412,348,1100,.316,2340,5417,.432,1292,1689,.765,948,2464,3412,1501,592,324,1167,1856,7016,2002-2003
DENVER NUGGETS,82,19730,2689,6544,.411,229,824,.278,2460,5720,.430,1294,1850,.699,1112,2363,3475,1737,712,422,1514,2056,6901,2002-2003
DALLAS MAVERICKS,82,19805,3322,7230,.459,507,1456,.348,2815,5774,.488,1475,1854,.796,1174,2538,3712,1963,656,437,1000,1609,8626,2003-2004
SACRAMENTO KINGS,82,19780,3103,6711,.462,601,1498,.401,2502,5213,.480,1626,2044,.795,888,2492,3380,2152,710,325,1137,1586,8433,2003-2004
LOS ANGELES LAKERS,82,19855,3028,6676,.454,365,1115,.327,2663,5561,.479,1631,2352,.693,1001,2535,3536,1948,682,379,1132,1732,8052,2003-2004
MILWAUKEE BUCKS,82,19780,2970,6650,.447,401,1145,.350,2569,5505,.467,1698,2192,.775,960,2502,3462,1872,554,383,1110,1668,8039,2003-2004
DENVER NUGGETS,82,19730,2993,6763,.443,331,985,.336,2662,5778,.461,1655,2159,.767,1083,2387,3470,1794,745,520,1278,1804,7972,2003-2004
SEATTLE SUPERSONICS,82,19805,2939,6590,.446,723,1936,.373,2216,4654,.476,1363,1782,.765,907,2318,3225,1782,661,387,1188,1784,7964,2003-2004
MEMPHIS GRIZZLIES,82,19880,2963,6657,.445,447,1314,.340,2516,5343,.471,1557,2143,.727,1047,2381,3428,1915,795,565,1226,1903,7930,2003-2004
BOSTON CELTICS,82,19705,2843,6415,.443,553,1599,.346,2290,4816,.475,1572,2095,.750,851,2440,3291,1683,770,331,1332,1837,7811,2003-2004
LOS ANGELES CLIPPERS,82,19805,2817,6579,.428,329,1024,.321,2488,5555,.448,1808,2302,.785,1149,2416,3565,1653,594,376,1344,1816,7771,2003-2004
MINNESOTA TIMBERWOLVES,82,19755,3033,6571,.462,326,897,.363,2707,5674,.477,1361,1743,.781,875,2645,3520,1890,561,462,1043,1731,7753,2003-2004
PHOENIX SUNS,82,19730,2958,6671,.443,415,1202,.345,2543,5469,.465,1392,1865,.746,924,2406,3330,1586,734,383,1249,1862,7723,2003-2004
ORLANDO MAGIC,82,19830,2904,6768,.429,429,1248,.344,2475,5520,.448,1474,2000,.737,1003,2350,3353,1584,547,308,1123,1744,7711,2003-2004
GOLDEN STATE WARRIORS,82,19855,2875,6511,.442,429,1283,.334,2446,5228,.468,1470,2028,.725,1002,2533,3535,1681,576,389,1211,1691,7649,2003-2004
CLEVELAND CAVALIERS,82,19855,2922,6753,.433,247,786,.314,2675,5967,.448,1528,2030,.753,1118,2619,3737,1808,585,537,1216,1743,7619,2003-2004
ATLANTA HAWKS,82,19905,2829,6529,.433,419,1249,.335,2410,5280,.456,1534,1976,.776,996,2507,3503,1648,627,408,1350,1826,7611,2003-2004
NEW YORK KNICKS,82,19880,2881,6513,.442,406,1115,.364,2475,5398,.459,1374,1732,.793,950,2543,3493,1695,608,391,1289,1897,7542,2003-2004
NEW ORLEANS HORNETS,82,19830,2772,6605,.420,531,1666,.319,2241,4939,.454,1454,1937,.751,1091,2418,3509,1716,708,346,1228,1715,7529,2003-2004
WASHINGTON WIZARDS,82,19830,2758,6556,.421,433,1269,.341,2325,5287,.440,1579,2211,.714,1115,2392,3507,1537,733,406,1439,1712,7528,2003-2004
SAN ANTONIO SPURS,82,19755,2842,6434,.442,408,1140,.358,2434,5294,.460,1409,2069,.681,1029,2669,3698,1676,661,537,1203,1667,7501,2003-2004
INDIANA PACERS,82,19805,2753,6322,.435,449,1281,.351,2304,5041,.457,1538,2014,.764,965,2452,3417,1774,726,411,1182,1709,7493,2003-2004
PORTLAND TRAIL BLAZERS,82,19980,2898,6467,.448,381,1102,.346,2517,5365,.469,1263,1728,.731,1040,2376,3416,1768,613,443,1213,1554,7440,2003-2004
MIAMI HEAT,82,19755,2729,6417,.425,485,1357,.357,2244,5060,.443,1459,1915,.762,940,2459,3399,1565,590,313,1137,1812,7402,2003-2004
NEW JERSEY NETS,82,19705,2813,6372,.441,377,1123,.336,2436,5249,.464,1398,1856,.753,862,2473,3335,2009,709,322,1209,1722,7401,2003-2004
DETROIT PISTONS,82,19780,2747,6314,.435,333,968,.344,2414,5346,.452,1561,2074,.753,1014,2492,3506,1702,659,570,1241,1664,7388,2003-2004
HOUSTON ROCKETS,82,19930,2738,6195,.442,515,1406,.366,2223,4789,.464,1371,1774,.773,847,2647,3494,1579,560,443,1373,1762,7362,2003-2004
CHICAGO BULLS,82,19830,2798,6753,.414,429,1256,.342,2369,5497,.431,1330,1834,.725,1048,2519,3567,1793,659,396,1321,1911,7355,2003-2004
UTAH JAZZ,82,19780,2690,6172,.436,252,786,.321,2438,5386,.453,1639,2196,.746,1103,2272,3375,1671,583,494,1365,2096,7271,2003-2004
PHILADELPHIA 76ERS,82,19855,2682,6260,.428,339,992,.342,2343,5268,.445,1512,2009,.753,941,2408,3349,1640,654,358,1307,1701,7215,2003-2004
TORONTO RAPTORS,82,19980,2654,6348,.418,461,1294,.356,2193,5054,.434,1237,1650,.750,830,2419,3249,1574,604,402,1164,1748,7006,2003-2004
PHOENIX SUNS,82,19780,3351,7018,.477,796,2026,.393,2555,4992,.512,1556,2080,.748,967,2652,3619,1927,572,453,1125,1563,9054,2004-2005
SACRAMENTO KINGS,82,19855,3203,6978,.459,522,1396,.374,2681,5582,.480,1577,2004,.787,1023,2455,3478,2005,674,316,1073,1685,8505,2004-2005
DALLAS MAVERICKS,82,19730,3058,6691,.457,463,1273,.364,2595,5418,.479,1826,2314,.789,990,2530,3520,1610,708,461,1102,1827,8405,2004-2005
MIAMI HEAT,82,19980,3097,6368,.486,475,1260,.377,2622,5108,.513,1658,2466,.672,887,2639,3526,1790,528,474,1127,1814,8327,2004-2005
BOSTON CELTICS,82,19880,3046,6511,.468,437,1252,.349,2609,5259,.496,1775,2323,.764,909,2438,3347,1810,667,423,1297,2000,8304,2004-2005
WASHINGTON WIZARDS,82,19780,2966,6794,.437,514,1498,.343,2452,5296,.463,1795,2476,.725,1133,2374,3507,1563,716,347,1172,1807,8241,2004-2005
TORONTO RAPTORS,82,19805,2952,6656,.444,648,1681,.385,2304,4975,.463,1626,2101,.774,844,2444,3288,1670,621,317,1087,1876,8178,2004-2005
DENVER NUGGETS,82,19755,3038,6615,.459,320,940,.340,2718,5675,.479,1765,2313,.763,967,2473,3440,1958,750,489,1224,1878,8161,2004-2005
ORLANDO MAGIC,82,19705,3034,6679,.454,320,916,.349,2714,5763,.471,1772,2335,.759,1038,2544,3582,1583,633,441,1322,1937,8160,2004-2005
PHILADELPHIA 76ERS,82,19855,2946,6736,.437,505,1453,.348,2441,5283,.462,1731,2194,.789,909,2536,3445,1710,756,321,1274,1878,8128,2004-2005
SEATTLE SUPERSONICS,82,19755,2882,6498,.444,666,1824,.365,2216,4674,.474,1683,2131,.790,1041,2311,3352,1487,553,338,1113,1944,8113,2004-2005
LOS ANGELES LAKERS,82,19780,2895,6629,.437,644,1813,.355,2251,4816,.467,1661,2137,.777,1028,2511,3539,1672,508,344,1176,1794,8095,2004-2005
GOLDEN STATE WARRIORS,82,19905,3029,7039,.430,624,1774,.352,2405,5265,.457,1412,1955,.722,1069,2436,3505,1811,642,420,1112,1833,8094,2004-2005
NEW YORK KNICKS,82,19880,2978,6599,.451,441,1240,.356,2537,5359,.473,1580,2060,.767,965,2393,3358,1665,629,260,1204,1942,7977,2004-2005
MILWAUKEE BUCKS,82,19780,2964,6580,.450,325,925,.351,2639,5655,.467,1720,2229,.772,985,2405,3390,1720,529,289,1132,1797,7973,2004-2005
MINNESOTA TIMBERWOLVES,82,19755,3045,6629,.459,395,1145,.345,2650,5484,.483,1449,1820,.796,947,2580,3527,1918,460,447,1079,1774,7934,2004-2005
CLEVELAND CAVALIERS,82,19855,2990,6687,.447,300,904,.332,2690,5783,.465,1634,2174,.752,1117,2352,3469,1851,654,461,1141,1850,7914,2004-2005
SAN ANTONIO SPURS,82,19805,2923,6450,.453,507,1395,.363,2416,5055,.478,1535,2120,.724,987,2489,3476,1771,613,543,1126,1717,7888,2004-2005
LOS ANGELES CLIPPERS,82,20030,2924,6368,.459,231,669,.345,2693,5699,.473,1770,2274,.778,980,2455,3435,1901,599,422,1290,1819,7849,2004-2005
HOUSTON ROCKETS,82,19855,2846,6419,.443,553,1521,.364,2293,4898,.468,1551,1986,.781,874,2601,3475,1733,563,378,1135,1807,7796,2004-2005
CHICAGO BULLS,82,19830,2849,6592,.432,511,1433,.357,2338,5159,.453,1536,2048,.750,1001,2591,3592,1743,576,369,1371,2028,7745,2004-2005
CHARLOTTE BOBCATS,82,19880,2961,6859,.432,320,881,.363,2641,5978,.442,1487,2096,.709,1083,2335,3418,1794,695,440,1192,1894,7729,2004-2005
MEMPHIS GRIZZLIES,82,19705,2802,6271,.447,531,1486,.357,2271,4785,.475,1526,2024,.754,887,2307,3194,1716,699,476,1197,1910,7661,2004-2005
DETROIT PISTONS,82,19955,2851,6421,.444,363,1053,.345,2488,5368,.463,1588,2150,.739,1054,2507,3561,1787,576,497,1133,1638,7653,2004-2005
INDIANA PACERS,82,19905,2668,6169,.432,542,1575,.344,2126,4594,.463,1748,2206,.792,868,2418,3286,1489,615,357,1173,1890,7626,2004-2005
UTAH JAZZ,82,19780,2828,6301,.449,250,762,.328,2578,5539,.465,1719,2272,.757,1047,2243,3290,1826,541,374,1292,2189,7625,2004-2005
PORTLAND TRAIL BLAZERS,82,19730,2896,6422,.451,420,1161,.362,2476,5261,.471,1409,1944,.725,970,2404,3374,1722,583,544,1308,1703,7621,2004-2005
ATLANTA HAWKS,82,19855,2942,6672,.441,304,973,.312,2638,5699,.463,1417,1994,.711,1100,2335,3435,1614,629,344,1319,2009,7605,2004-2005
NEW JERSEY NETS,82,19905,2753,6419,.429,435,1203,.362,2318,5216,.444,1555,2039,.763,855,2387,3242,1772,650,308,1164,1985,7496,2004-2005
NEW ORLEANS HORNETS,82,19930,2718,6556,.415,415,1316,.315,2303,5240,.440,1401,1830,.766,1019,2281,3300,1724,550,310,1217,1883,7252,2004-2005
PHOENIX SUNS,82,19955,3430,7167,.479,837,2097,.399,2593,5070,.511,1189,1475,.806,778,2650,3428,2179,549,412,1088,1683,8886,2005-2006
SEATTLE SUPERSONICS,82,19830,3077,6711,.459,605,1631,.371,2472,5080,.487,1652,2104,.785,1013,2233,3246,1696,622,306,1208,1933,8411,2005-2006
WASHINGTON WIZARDS,82,19830,2975,6656,.447,497,1394,.357,2478,5262,.471,1889,2496,.757,1035,2344,3379,1523,658,339,1143,1855,8336,2005-2006
TORONTO RAPTORS,82,19955,3013,6639,.454,608,1620,.375,2405,5019,.479,1653,2089,.791,864,2291,3155,1593,529,272,1071,1965,8287,2005-2006
DENVER NUGGETS,82,19930,3078,6672,.461,350,1076,.325,2728,5596,.487,1721,2312,.744,903,2486,3389,1921,698,463,1216,1863,8227,2005-2006
MIAMI HEAT,82,19755,3039,6355,.478,497,1441,.345,2542,4914,.517,1616,2310,.700,858,2675,3533,1692,522,442,1186,1871,8191,2005-2006
LOS ANGELES LAKERS,82,19855,2992,6607,.453,552,1583,.349,2440,5024,.486,1618,2172,.745,970,2488,3458,1734,628,350,1143,1894,8154,2005-2006
PHILADELPHIA 76ERS,82,19905,3001,6546,.458,375,1031,.364,2626,5515,.476,1770,2330,.760,873,2425,3298,1653,651,404,1159,1712,8147,2005-2006
DALLAS MAVERICKS,82,19880,2948,6375,.462,416,1113,.374,2532,5262,.481,1818,2322,.783,1030,2431,3461,1473,593,488,1112,1834,8130,2005-2006
SACRAMENTO KINGS,82,19830,2954,6500,.454,494,1408,.351,2460,5092,.483,1704,2173,.784,852,2473,3325,1825,608,299,1199,1672,8106,2005-2006
GOLDEN STATE WARRIORS,82,19830,2939,6785,.433,625,1832,.341,2314,4953,.467,1573,2190,.718,980,2485,3465,1694,604,357,1156,1941,8076,2005-2006
BOSTON CELTICS,82,19880,2951,6322,.467,467,1290,.362,2484,5032,.494,1664,2204,.755,813,2432,3245,1716,578,422,1359,2033,8033,2005-2006
MILWAUKEE BUCKS,82,19855,2976,6566,.453,507,1335,.380,2469,5231,.472,1561,2115,.738,929,2448,3377,1769,597,270,1197,1902,8020,2005-2006
CHICAGO BULLS,82,19905,3004,6737,.446,560,1477,.379,2444,5260,.465,1452,1967,.738,906,2602,3508,1804,508,345,1224,2038,8020,2005-2006
CLEVELAND CAVALIERS,82,19830,2908,6412,.454,497,1465,.339,2411,4947,.487,1689,2318,.729,959,2511,3470,1560,567,392,1137,1733,8002,2005-2006
ATLANTA HAWKS,82,19880,2946,6496,.454,424,1154,.367,2522,5342,.472,1656,2207,.750,1069,2232,3301,1625,587,394,1284,2054,7972,2005-2006
LOS ANGELES CLIPPERS,82,19805,2993,6443,.465,290,843,.344,2703,5600,.483,1694,2142,.791,828,2704,3532,1708,534,503,1185,1872,7970,2005-2006
CHARLOTTE BOBCATS,82,19905,2961,6843,.433,428,1261,.339,2533,5582,.454,1593,2186,.729,990,2270,3260,1717,822,354,1167,1960,7943,2005-2006
DETROIT PISTONS,82,19830,2983,6558,.455,557,1451,.384,2426,5107,.475,1418,1950,.727,975,2347,3322,1971,580,490,931,1513,7941,2005-2006
NEW YORK KNICKS,82,19930,2822,6206,.455,320,884,.362,2502,5322,.470,1878,2587,.726,1034,2360,3394,1468,555,271,1449,2157,7842,2005-2006
SAN ANTONIO SPURS,82,19805,2993,6342,.472,524,1362,.385,2469,4980,.496,1327,1891,.702,851,2548,3399,1717,543,467,1126,1714,7837,2005-2006
ORLANDO MAGIC,82,19905,2911,6167,.472,299,796,.376,2612,5371,.486,1663,2277,.730,892,2402,3294,1495,532,362,1240,1908,7784,2005-2006
INDIANA PACERS,82,19730,2786,6274,.444,536,1536,.349,2250,4738,.475,1591,2158,.737,898,2559,3457,1631,598,409,1254,1821,7699,2005-2006
NEW JERSEY NETS,82,19780,2778,6317,.440,477,1447,.330,2301,4870,.472,1658,2187,.758,822,2539,3361,1884,558,278,1119,1903,7691,2005-2006
NEW ORLEANS/OKLAHOMA CITY HORNETS,82,19805,2831,6428,.440,300,885,.339,2531,5543,.457,1649,2176,.758,918,2379,3297,1519,611,311,1095,1786,7611,2005-2006
UTAH JAZZ,82,19880,2744,6207,.442,311,925,.336,2433,5282,.461,1774,2466,.719,1071,2380,3451,1772,524,492,1290,2032,7573,2005-2006
MEMPHIS GRIZZLIES,82,19855,2746,6125,.448,590,1578,.374,2156,4547,.474,1476,2077,.711,834,2379,3213,1586,600,442,1134,1757,7558,2005-2006
MINNESOTA TIMBERWOLVES,82,19855,2888,6340,.456,310,942,.329,2578,5398,.478,1436,1895,.758,811,2422,3233,1716,559,471,1189,1889,7522,2005-2006
HOUSTON ROCKETS,82,19830,2708,6252,.433,469,1414,.332,2239,4838,.463,1502,1980,.759,849,2565,3414,1580,588,320,1193,1863,7387,2005-2006
PORTLAND TRAIL BLAZERS,82,19730,2791,6267,.445,364,1042,.349,2427,5225,.464,1339,1944,.689,886,2203,3089,1490,529,435,1205,1828,7285,2005-2006
PHOENIX SUNS,82,19905,3388,6855,.494,785,1965,.399,2603,4890,.532,1476,1827,.808,737,2583,3320,2122,553,394,1189,1659,9037,2006-2007
GOLDEN STATE WARRIORS,82,19755,3261,7048,.463,700,1967,.356,2561,5081,.504,1515,2113,.717,940,2456,3396,1950,750,466,1309,1933,8737,2006-2007
DENVER NUGGETS,82,19780,3164,6805,.465,484,1440,.336,2680,5365,.500,1827,2449,.746,1001,2558,3559,1920,678,435,1352,1756,8639,2006-2007
WASHINGTON WIZARDS,82,19830,3070,6820,.450,561,1614,.348,2509,5206,.482,1855,2425,.765,998,2379,3377,1660,635,375,1133,1823,8556,2006-2007
LOS ANGELES LAKERS,82,20030,3103,6664,.466,608,1724,.353,2495,4940,.505,1660,2221,.747,886,2495,3381,1850,600,421,1273,1889,8474,2006-2007
MEMPHIS GRIZZLIES,82,19980,2998,6448,.465,500,1362,.367,2498,5086,.491,1835,2410,.761,866,2375,3241,1680,564,407,1343,1827,8331,2006-2007
UTAH JAZZ,82,19805,3069,6471,.474,354,1056,.335,2715,5415,.501,1830,2462,.743,1030,2456,3486,2024,577,339,1277,2067,8322,2006-2007
SACRAMENTO KINGS,82,19805,2941,6532,.450,530,1513,.350,2411,5019,.480,1891,2473,.765,797,2396,3193,1665,671,265,1194,1792,8303,2006-2007
DALLAS MAVERICKS,82,19755,3010,6442,.467,535,1404,.381,2475,5038,.491,1646,2045,.805,920,2515,3435,1632,560,408,1140,1837,8201,2006-2007
MILWAUKEE BUCKS,82,19855,3121,6714,.465,524,1472,.356,2597,5242,.495,1406,1919,.733,941,2272,3213,1771,587,224,1240,1821,8172,2006-2007
TORONTO RAPTORS,82,19755,3032,6547,.463,531,1464,.363,2501,5083,.492,1562,1982,.788,755,2480,3235,1822,581,321,1104,1672,8157,2006-2007
SEATTLE SUPERSONICS,82,19830,3047,6628,.460,525,1451,.362,2522,5177,.487,1511,1911,.791,928,2322,3250,1695,631,301,1268,1801,8130,2006-2007
CHICAGO BULLS,82,19780,3046,6663,.457,480,1237,.388,2566,5426,.473,1528,2083,.734,984,2597,3581,1832,639,445,1310,1908,8100,2006-2007
SAN ANTONIO SPURS,82,19780,2999,6328,.474,595,1561,.381,2404,4767,.504,1486,1980,.751,761,2577,3338,1814,587,417,1137,1588,8079,2006-2007
NEW JERSEY NETS,82,19880,2913,6379,.457,609,1676,.363,2304,4703,.490,1566,2153,.727,822,2525,3347,1962,499,273,1212,1869,8001,2006-2007
NEW YORK KNICKS,82,20005,2903,6356,.457,474,1370,.346,2429,4986,.487,1714,2396,.715,1032,2516,3548,1532,543,260,1405,1932,7994,2006-2007
HOUSTON ROCKETS,82,19855,2906,6528,.445,705,1893,.372,2201,4635,.475,1436,1906,.753,880,2673,3553,1704,583,337,1162,1710,7953,2006-2007
CHARLOTTE BOBCATS,82,20005,2960,6643,.446,457,1280,.357,2503,5363,.467,1568,2136,.734,920,2346,3266,1836,638,369,1224,1985,7945,2006-2007
CLEVELAND CAVALIERS,82,19880,2978,6658,.447,494,1404,.352,2484,5254,.473,1484,2133,.696,1039,2529,3568,1708,625,353,1177,1781,7934,2006-2007
MINNESOTA TIMBERWOLVES,82,20005,2997,6503,.461,384,1089,.353,2613,5414,.483,1499,1892,.792,819,2474,3293,1848,532,325,1278,1758,7877,2006-2007
DETROIT PISTONS,82,19880,2942,6484,.454,449,1305,.344,2493,5179,.481,1539,1988,.774,948,2374,3322,1768,583,472,1001,1672,7872,2006-2007
BOSTON CELTICS,82,19855,2858,6454,.443,471,1283,.367,2387,5171,.462,1670,2178,.767,918,2391,3309,1630,589,382,1350,1971,7857,2006-2007
LOS ANGELES CLIPPERS,82,19730,2880,6318,.456,314,903,.348,2566,5415,.474,1769,2245,.788,888,2484,3372,1762,596,472,1239,1858,7843,2006-2007
INDIANA PACERS,82,19780,2872,6561,.438,481,1389,.346,2391,5172,.462,1615,2125,.760,990,2441,3431,1680,599,447,1335,1912,7840,2006-2007
NEW ORLEANS/OKLAHOMA CITY HORNETS,82,19880,2971,6674,.445,455,1256,.362,2516,5418,.464,1436,1941,.740,1025,2512,3537,1537,522,347,1187,1620,7833,2006-2007
PHILADELPHIA 76ERS,82,19880,2932,6408,.458,284,823,.345,2648,5585,.474,1637,2135,.767,899,2353,3252,1669,590,390,1258,1671,7785,2006-2007
ORLANDO MAGIC,82,19780,2875,6090,.472,342,962,.356,2533,5128,.494,1679,2393,.702,920,2418,3338,1525,565,416,1392,1904,7771,2006-2007
MIAMI HEAT,82,19855,2919,6288,.464,528,1539,.343,2391,4749,.503,1393,2019,.690,817,2526,3343,1681,566,442,1201,1749,7759,2006-2007
PORTLAND TRAIL BLAZERS,82,19955,2874,6392,.450,426,1232,.346,2448,5160,.474,1543,2006,.769,923,2299,3222,1513,555,380,1236,1931,7717,2006-2007
ATLANTA HAWKS,82,19880,2831,6372,.444,341,1038,.329,2490,5334,.467,1677,2203,.761,976,2312,3288,1573,609,446,1306,1970,7680,2006-2007
GOLDEN STATE WARRIORS,82,19780,3403,7406,.459,761,2185,.348,2642,5221,.506,1538,2044,.752,1045,2496,3541,1833,744,377,1082,1875,9105,2007-2008
DENVER NUGGETS,82,19855,3307,7038,.470,569,1605,.355,2738,5433,.504,1891,2519,.751,918,2698,3616,2024,752,551,1203,1731,9074,2007-2008
PHOENIX SUNS,82,19780,3392,6782,.500,694,1764,.393,2698,5018,.538,1548,1977,.783,720,2683,3403,2188,532,518,1184,1633,9026,2007-2008
LOS ANGELES LAKERS,82,19780,3248,6818,.476,662,1751,.378,2586,5067,.510,1746,2270,.769,898,2722,3620,2003,654,438,1156,1691,8904,2007-2008
UTAH JAZZ,82,19705,3279,6592,.497,407,1095,.372,2872,5497,.522,1745,2298,.759,942,2410,3352,2165,717,355,1200,1970,8710,2007-2008
ORLANDO MAGIC,82,19780,3058,6446,.474,801,2074,.386,2257,4372,.516,1650,2288,.721,768,2677,3445,1706,520,333,1173,1688,8567,2007-2008
INDIANA PACERS,82,19755,3102,6993,.444,755,2021,.374,2347,4972,.472,1568,2042,.768,904,2633,3537,1864,623,412,1236,1921,8527,2007-2008
SACRAMENTO KINGS,82,19830,3043,6558,.464,510,1367,.373,2533,5191,.488,1812,2272,.798,829,2456,3285,1567,651,334,1317,1839,8408,2007-2008
NEW ORLEANS HORNETS,82,19805,3164,6796,.466,630,1621,.389,2534,5175,.490,1312,1707,.769,937,2494,3431,1785,637,321,974,1531,8270,2007-2008
MEMPHIS GRIZZLIES,82,19805,3060,6737,.454,620,1779,.349,2440,4958,.492,1517,2097,.723,848,2567,3415,1574,503,386,1251,1592,8257,2007-2008
BOSTON CELTICS,82,19755,2986,6286,.475,596,1564,.381,2390,4722,.506,1677,2176,.771,830,2615,3445,1833,696,379,1246,1864,8245,2007-2008
DALLAS MAVERICKS,82,19730,3025,6515,.464,494,1403,.352,2531,5112,.495,1690,2075,.814,883,2643,3526,1720,490,402,1037,1786,8234,2007-2008
TORONTO RAPTORS,82,19830,3148,6726,.468,572,1459,.392,2576,5267,.489,1347,1658,.812,790,2496,3286,1953,570,336,959,1596,8215,2007-2008
WASHINGTON WIZARDS,82,19905,2986,6695,.446,575,1614,.356,2411,5081,.475,1557,1991,.782,1007,2404,3411,1607,632,391,1082,1606,8104,2007-2008
ATLANTA HAWKS,82,19855,2975,6552,.454,384,1078,.356,2591,5474,.473,1720,2227,.772,1008,2454,3462,1804,600,448,1223,1673,8054,2007-2008
SEATTLE SUPERSONICS,82,19830,3125,7032,.444,313,939,.333,2812,6093,.462,1436,1866,.770,971,2688,3659,1748,531,400,1310,1680,7999,2007-2008
DETROIT PISTONS,82,19730,2999,6551,.458,487,1330,.366,2512,5221,.481,1507,1965,.767,974,2423,3397,1831,583,472,956,1688,7992,2007-2008
CHICAGO BULLS,82,19805,2987,6861,.435,474,1305,.363,2513,5556,.452,1533,2029,.756,1050,2478,3528,1811,635,429,1197,1784,7981,2007-2008
CHARLOTTE BOBCATS,82,19880,2960,6554,.452,529,1443,.367,2431,5111,.476,1510,2115,.714,892,2440,3332,1748,614,402,1204,1777,7959,2007-2008
MILWAUKEE BUCKS,82,19855,3026,6745,.449,452,1313,.344,2574,5432,.474,1452,1980,.733,1055,2363,3418,1760,544,361,1210,1748,7956,2007-2008
NEW YORK KNICKS,82,19880,2967,6757,.439,490,1454,.337,2477,5303,.467,1524,2095,.727,1029,2457,3486,1530,521,213,1187,1761,7948,2007-2008
HOUSTON ROCKETS,82,19730,3003,6698,.448,583,1707,.342,2420,4991,.485,1342,1848,.726,1002,2659,3661,1757,598,420,1125,1609,7931,2007-2008
PHILADELPHIA 76ERS,82,19755,3056,6648,.460,302,952,.317,2754,5696,.483,1509,2137,.706,1067,2370,3437,1673,712,400,1172,1620,7923,2007-2008
CLEVELAND CAVALIERS,82,19855,2937,6697,.439,552,1544,.358,2385,5153,.463,1477,2061,.717,1092,2563,3655,1640,579,427,1145,1712,7903,2007-2008
NEW JERSEY NETS,82,19830,2856,6450,.443,498,1430,.348,2358,5020,.470,1647,2237,.736,913,2520,3433,1925,521,390,1229,1855,7857,2007-2008
MINNESOTA TIMBERWOLVES,82,19730,3076,6817,.451,441,1259,.350,2635,5558,.474,1246,1693,.736,964,2428,3392,1630,616,306,1188,1885,7839,2007-2008
PORTLAND TRAIL BLAZERS,82,19905,2935,6546,.448,538,1426,.377,2397,5120,.468,1412,1841,.767,901,2438,3339,1733,455,360,1056,1642,7820,2007-2008
SAN ANTONIO SPURS,82,19730,2938,6424,.457,594,1610,.369,2344,4814,.487,1350,1774,.761,771,2612,3383,1718,521,337,1035,1537,7820,2007-2008
LOS ANGELES CLIPPERS,82,19805,2820,6445,.438,350,1079,.324,2470,5366,.460,1702,2178,.781,800,2491,3291,1732,557,398,1180,1745,7692,2007-2008
MIAMI HEAT,82,19830,2808,6336,.443,491,1373,.358,2317,4963,.467,1384,1903,.727,743,2342,3085,1644,589,355,1202,1670,7491,2007-2008
PHOENIX SUNS,82,19755,3373,6695,.504,553,1445,.383,2820,5250,.537,1675,2251,.744,900,2520,3420,1905,589,420,1288,1691,8974,2008-2009
GOLDEN STATE WARRIORS,82,19880,3231,7055,.458,550,1475,.373,2681,5580,.480,1893,2392,.791,953,2492,3445,1711,638,527,1201,1842,8905,2008-2009
LOS ANGELES LAKERS,82,19780,3307,6981,.474,547,1516,.361,2760,5465,.505,1607,2087,.770,1015,2587,3602,1908,718,420,1103,1698,8768,2008-2009
NEW YORK KNICKS,82,19805,3157,7091,.445,823,2284,.360,2334,4807,.486,1490,1900,.784,911,2545,3456,1738,610,204,1174,1672,8627,2008-2009
INDIANA PACERS,82,19830,3220,7080,.455,652,1725,.378,2568,5355,.480,1525,1890,.807,924,2661,3585,1775,573,434,1189,1895,8617,2008-2009
DENVER NUGGETS,82,19730,3058,6510,.470,548,1477,.371,2510,5033,.499,1891,2487,.760,905,2507,3412,1820,710,492,1257,1874,8555,2008-2009
UTAH JAZZ,82,19880,3143,6623,.475,392,1122,.349,2751,5501,.500,1814,2352,.771,940,2423,3363,2024,719,374,1210,1830,8492,2008-2009
CHICAGO BULLS,82,19930,3126,6846,.457,493,1293,.381,2633,5553,.474,1633,2052,.796,970,2481,3451,1732,615,453,1192,1709,8378,2008-2009
DALLAS MAVERICKS,82,19805,3128,6770,.462,571,1632,.350,2557,5138,.498,1516,1852,.819,909,2595,3504,1779,591,429,1043,1600,8343,2008-2009
ORLANDO MAGIC,82,19730,2929,6416,.457,817,2147,.381,2112,4269,.495,1611,2253,.715,819,2728,3547,1593,570,439,1142,1664,8286,2008-2009
BOSTON CELTICS,82,19880,3075,6333,.486,538,1355,.397,2537,4978,.510,1587,2075,.765,869,2586,3455,1862,621,387,1280,1897,8275,2008-2009
SACRAMENTO KINGS,82,19905,2990,6685,.447,586,1594,.368,2404,5091,.472,1682,2107,.798,840,2366,3206,1619,569,349,1266,1910,8248,2008-2009
CLEVELAND CAVALIERS,82,19780,3022,6454,.468,656,1670,.393,2366,4784,.495,1523,2012,.757,886,2574,3460,1663,593,435,1045,1663,8223,2008-2009
PORTLAND TRAIL BLAZERS,82,19830,3018,6494,.465,596,1555,.383,2422,4939,.490,1521,1988,.765,1060,2360,3420,1667,550,402,1055,1671,8153,2008-2009
MILWAUKEE BUCKS,82,19780,3009,6755,.445,511,1408,.363,2498,5347,.467,1613,2067,.780,973,2367,3340,1802,609,308,1154,1986,8142,2008-2009
TORONTO RAPTORS,82,19805,3054,6673,.458,479,1289,.372,2575,5384,.478,1534,1861,.824,802,2513,3315,1835,523,390,1098,1593,8121,2008-2009
HOUSTON ROCKETS,82,19805,2959,6526,.453,621,1656,.375,2338,4870,.480,1531,1903,.805,862,2662,3524,1662,548,355,1158,1553,8070,2008-2009
MIAMI HEAT,82,19955,3034,6646,.457,582,1631,.357,2452,5015,.489,1411,1871,.754,828,2411,3239,1671,651,451,1026,1696,8061,2008-2009
ATLANTA HAWKS,82,19705,2956,6451,.458,597,1633,.366,2359,4818,.490,1537,2085,.737,870,2412,3282,1657,603,376,1048,1610,8046,2008-2009
NEW JERSEY NETS,82,19830,2925,6536,.448,652,1735,.376,2273,4801,.473,1542,1980,.779,850,2415,3265,1636,559,391,1075,1838,8044,2008-2009
MINNESOTA TIMBERWOLVES,82,19805,2986,6766,.441,543,1539,.353,2443,5227,.467,1504,1957,.769,975,2442,3417,1674,512,322,1165,1785,8019,2008-2009
PHILADELPHIA 76ERS,82,19755,2997,6532,.459,341,1072,.318,2656,5460,.486,1652,2216,.745,1039,2336,3375,1647,658,415,1157,1650,7987,2008-2009
SAN ANTONIO SPURS,82,19905,3042,6534,.466,625,1620,.386,2417,4914,.492,1249,1641,.761,728,2638,3366,1736,474,329,963,1546,7958,2008-2009
OKLAHOMA CITY THUNDER,82,19805,2999,6716,.447,328,949,.346,2671,5767,.463,1626,2069,.786,999,2497,3496,1663,608,371,1330,1655,7952,2008-2009
WASHINGTON WIZARDS,82,19705,2994,6655,.450,395,1198,.330,2599,5457,.476,1494,1948,.767,956,2330,3286,1641,619,365,1146,1679,7877,2008-2009
NEW ORLEANS HORNETS,82,19755,2911,6366,.457,556,1526,.364,2355,4840,.487,1479,1833,.807,802,2453,3255,1609,593,338,1029,1665,7857,2008-2009
LOS ANGELES CLIPPERS,82,19880,2955,6696,.441,535,1513,.354,2420,5183,.467,1354,1839,.736,890,2377,3267,1723,572,482,1221,1650,7799,2008-2009
DETROIT PISTONS,82,19905,2981,6559,.454,377,1079,.349,2604,5480,.475,1388,1849,.751,949,2448,3397,1689,493,377,973,1712,7727,2008-2009
MEMPHIS GRIZZLIES,82,19805,2865,6311,.454,398,1106,.360,2467,5205,.474,1570,2077,.756,847,2337,3184,1423,615,385,1252,1777,7698,2008-2009
CHARLOTTE BOBCATS,82,19930,2866,6299,.455,490,1339,.366,2376,4960,.479,1455,1965,.740,886,2366,3252,1741,580,397,1279,1754,7677,2008-2009
PHOENIX SUNS,82,19730,3339,6788,.492,730,1770,.412,2609,5018,.520,1631,2117,.770,910,2616,3526,1912,479,418,1210,1713,9039,2009-2010
GOLDEN STATE WARRIORS,82,19730,3329,7094,.469,633,1687,.375,2696,5407,.499,1631,2085,.782,753,2397,3150,1839,761,340,1204,1886,8922,2009-2010
DENVER NUGGETS,82,19780,3124,6678,.468,544,1517,.359,2580,5161,.500,1937,2508,.772,889,2505,3394,1719,683,417,1136,1844,8729,2009-2010
UTAH JAZZ,82,19755,3227,6575,.491,439,1207,.364,2788,5368,.519,1654,2233,.741,872,2588,3460,2187,675,400,1246,1859,8547,2009-2010
TORONTO RAPTORS,82,19780,3199,6631,.482,518,1397,.371,2681,5234,.512,1618,2118,.764,806,2507,3313,1804,469,384,1100,1819,8534,2009-2010
ORLANDO MAGIC,82,19730,3005,6394,.470,841,2241,.375,2164,4153,.521,1575,2176,.724,810,2736,3546,1615,512,456,1155,1629,8426,2009-2010
MEMPHIS GRIZZLIES,82,19905,3223,6875,.469,344,1020,.337,2879,5855,.492,1614,2202,.733,1070,2496,3566,1543,645,399,1248,1655,8404,2009-2010
HOUSTON ROCKETS,82,19905,3094,6923,.447,646,1838,.351,2448,5085,.481,1561,2022,.772,971,2471,3442,1790,583,318,1188,1712,8395,2009-2010
NEW YORK KNICKS,82,19880,3127,6876,.455,743,2145,.346,2384,4731,.504,1376,1759,.782,836,2477,3313,1772,586,305,1148,1638,8373,2009-2010
CLEVELAND CAVALIERS,82,19780,3101,6391,.485,602,1582,.381,2499,4809,.520,1569,2180,.720,791,2692,3483,1835,564,425,1137,1591,8373,2009-2010
DALLAS MAVERICKS,82,19880,3140,6760,.464,558,1498,.372,2582,5262,.491,1526,1870,.816,834,2586,3420,1917,624,449,1059,1563,8364,2009-2010
LOS ANGELES LAKERS,82,19830,3144,6875,.457,532,1562,.341,2612,5313,.492,1519,1985,.765,973,2662,3635,1730,612,400,1096,1592,8339,2009-2010
ATLANTA HAWKS,82,19855,3181,6801,.468,524,1455,.360,2657,5346,.497,1452,1914,.759,969,2451,3420,1789,592,413,980,1632,8338,2009-2010
OKLAHOMA CITY THUNDER,82,19805,3063,6629,.462,418,1229,.340,2645,5400,.490,1778,2210,.805,960,2607,3567,1639,654,481,1227,1743,8322,2009-2010
SAN ANTONIO SPURS,82,19780,3150,6659,.473,554,1547,.358,2596,5112,.508,1458,1969,.740,887,2621,3508,1829,516,381,1116,1669,8312,2009-2010
INDIANA PACERS,82,19705,3020,6823,.443,659,1896,.348,2361,4927,.479,1564,2019,.775,785,2618,3403,1730,585,439,1232,1848,8263,2009-2010
NEW ORLEANS HORNETS,82,19830,3178,6842,.464,571,1572,.363,2607,5270,.495,1293,1661,.778,852,2450,3302,1828,625,300,1103,1606,8220,2009-2010
SACRAMENTO KINGS,82,19880,3144,6895,.456,482,1383,.349,2662,5512,.483,1430,1969,.726,977,2518,3495,1679,564,366,1226,1827,8200,2009-2010
BOSTON CELTICS,82,19780,3039,6294,.483,499,1433,.348,2540,4861,.523,1559,2090,.746,716,2449,3165,1930,701,402,1219,1816,8136,2009-2010
MINNESOTA TIMBERWOLVES,82,19780,3106,6923,.449,403,1181,.341,2703,5742,.471,1436,1926,.746,962,2556,3518,1626,597,306,1333,1699,8051,2009-2010
PORTLAND TRAIL BLAZERS,82,19855,2974,6453,.461,491,1388,.354,2483,5065,.490,1606,2033,.790,913,2383,3296,1674,523,350,1012,1715,8045,2009-2010
PHILADELPHIA 76ERS,82,19805,3087,6706,.460,474,1381,.343,2613,5325,.491,1366,1808,.756,941,2421,3362,1723,667,439,1192,1677,8014,2009-2010
MILWAUKEE BUCKS,82,19980,3050,6998,.436,645,1813,.356,2405,5185,.464,1264,1675,.755,965,2560,3525,1740,580,385,1085,1823,8009,2009-2010
CHICAGO BULLS,82,19905,3081,6825,.451,352,1066,.330,2729,5759,.474,1479,1962,.754,937,2715,3652,1704,531,478,1175,1648,7993,2009-2010
MIAMI HEAT,82,19880,2984,6518,.458,494,1426,.346,2490,5092,.489,1452,1931,.752,875,2553,3428,1548,605,457,1079,1710,7914,2009-2010
WASHINGTON WIZARDS,82,19830,3008,6700,.449,432,1225,.353,2576,5475,.471,1444,1895,.762,966,2458,3424,1557,493,421,1219,1752,7892,2009-2010
LOS ANGELES CLIPPERS,82,19705,3002,6601,.455,483,1457,.332,2519,5144,.490,1362,1867,.730,927,2502,3429,1810,532,466,1285,1581,7849,2009-2010
CHARLOTTE BOBCATS,82,19880,2858,6306,.453,460,1331,.346,2398,4975,.482,1637,2180,.751,858,2490,3348,1658,632,446,1290,1597,7813,2009-2010
DETROIT PISTONS,82,19780,2940,6602,.445,374,1190,.314,2566,5412,.474,1455,1998,.728,1053,2242,3295,1591,596,313,1100,1822,7709,2009-2010
NEW JERSEY NETS,82,19780,2813,6554,.429,377,1185,.318,2436,5369,.454,1572,2015,.780,897,2358,3255,1540,573,393,1182,1643,7575,2009-2010
DENVER NUGGETS,82,19705,3145,6613,.476,662,1704,.388,2483,4909,.506,1859,2429,.765,791,2652,3443,1813,605,352,1157,1719,8811,2010-2011
NEW YORK KNICKS,82,19780,3140,6867,.457,765,2081,.368,2375,4786,.496,1689,2087,.809,847,2470,3317,1757,625,475,1123,1743,8734,2010-2011
HOUSTON ROCKETS,82,19880,3170,6975,.454,677,1843,.367,2493,5132,.486,1668,2083,.801,962,2549,3511,1955,581,371,1110,1641,8685,2010-2011
PHOENIX SUNS,82,20005,3219,6844,.470,701,1857,.377,2518,4987,.505,1472,1939,.759,821,2478,3299,1945,545,357,1169,1666,8611,2010-2011
OKLAHOMA CITY THUNDER,82,20005,3066,6609,.464,487,1403,.347,2579,5206,.495,1977,2401,.823,903,2604,3507,1672,654,487,1156,1836,8596,2010-2011
SAN ANTONIO SPURS,82,19780,3148,6628,.475,685,1727,.397,2463,4901,.503,1521,1984,.767,829,2603,3432,1836,602,372,1101,1556,8502,2010-2011
GOLDEN STATE WARRIORS,82,19830,3251,7047,.461,685,1749,.392,2566,5298,.484,1290,1695,.761,955,2370,3325,1847,737,406,1198,1806,8477,2010-2011
MIAMI HEAT,82,19780,3031,6301,.481,547,1479,.370,2484,4822,.515,1760,2288,.769,790,2666,3456,1639,544,430,1142,1674,8369,2010-2011
LOS ANGELES LAKERS,82,19830,3128,6757,.463,524,1487,.352,2604,5270,.494,1541,1979,.779,989,2616,3605,1801,602,422,1073,1555,8321,2010-2011
MINNESOTA TIMBERWOLVES,82,19780,3090,7014,.441,589,1565,.376,2501,5449,.459,1519,1977,.768,1085,2556,3641,1650,592,422,1398,1825,8288,2010-2011
DALLAS MAVERICKS,82,19705,3069,6463,.475,645,1768,.365,2424,4695,.516,1437,1850,.777,780,2618,3398,1954,557,352,1145,1575,8220,2010-2011
MEMPHIS GRIZZLIES,82,19880,3200,6801,.471,309,926,.334,2891,5875,.492,1486,1981,.750,970,2391,3361,1691,771,441,1145,1705,8195,2010-2011
INDIANA PACERS,82,19780,3003,6787,.442,585,1653,.354,2418,5134,.471,1592,2035,.782,914,2657,3571,1611,584,456,1262,1782,8183,2010-2011
UTAH JAZZ,82,19880,3064,6590,.465,435,1256,.346,2629,5334,.493,1590,2061,.771,898,2338,3236,1921,629,484,1175,1865,8153,2010-2011
SACRAMENTO KINGS,82,19855,3134,6979,.449,428,1277,.335,2706,5702,.475,1455,1981,.734,1071,2526,3597,1675,608,391,1324,1805,8151,2010-2011
ORLANDO MAGIC,82,19830,2956,6411,.461,770,2103,.366,2186,4308,.507,1453,2101,.692,864,2679,3543,1636,548,384,1224,1640,8135,2010-2011
TORONTO RAPTORS,82,19780,3144,6755,.465,345,1091,.316,2799,5664,.494,1491,1976,.755,963,2343,3306,1795,581,350,1206,1807,8124,2010-2011
PHILADELPHIA 76ERS,82,19930,3125,6776,.461,443,1248,.355,2682,5528,.485,1426,1851,.770,850,2578,3428,1861,621,355,1063,1592,8119,2010-2011
LOS ANGELES CLIPPERS,82,19855,3015,6594,.457,513,1519,.338,2502,5075,.493,1546,2187,.707,955,2501,3456,1813,585,402,1343,1733,8089,2010-2011
CHICAGO BULLS,82,19830,3042,6587,.462,511,1415,.361,2531,5172,.489,1492,2008,.743,967,2654,3621,1827,592,468,1161,1639,8087,2010-2011
WASHINGTON WIZARDS,82,19930,3048,6888,.443,392,1182,.332,2656,5706,.465,1489,1999,.745,1013,2374,3387,1592,665,502,1258,1850,7977,2010-2011
DETROIT PISTONS,82,19880,3056,6647,.460,472,1256,.376,2584,5391,.479,1367,1854,.737,931,2236,3167,1730,595,328,1067,1629,7951,2010-2011
BOSTON CELTICS,82,19780,3023,6219,.486,408,1119,.365,2615,5100,.513,1459,1895,.770,639,2542,3181,1921,676,344,1195,1678,7913,2010-2011
PORTLAND TRAIL BLAZERS,82,19805,2951,6599,.447,518,1503,.345,2433,5096,.477,1476,1835,.804,996,2230,3226,1736,660,358,1070,1585,7896,2010-2011
CLEVELAND CAVALIERS,82,19755,2886,6647,.434,509,1489,.342,2377,5158,.461,1546,2075,.745,856,2449,3305,1720,544,341,1166,1648,7827,2010-2011
ATLANTA HAWKS,82,19730,2971,6429,.462,502,1427,.352,2469,5002,.494,1346,1728,.779,762,2460,3222,1802,497,341,1118,1554,7790,2010-2011
NEW ORLEANS HORNETS,82,19830,2944,6416,.459,444,1232,.360,2500,5184,.482,1452,1897,.765,824,2468,3292,1691,624,359,1069,1719,7784,2010-2011
NEW JERSEY NETS,82,20005,2918,6638,.440,459,1337,.343,2459,5301,.464,1427,1881,.759,909,2440,3349,1723,458,384,1152,1807,7722,2010-2011
CHARLOTTE BOBCATS,82,19805,2873,6365,.451,393,1203,.327,2480,5162,.480,1511,1999,.756,848,2444,3292,1728,524,433,1192,1637,7650,2010-2011
MILWAUKEE BUCKS,82,19830,2814,6544,.430,483,1414,.342,2331,5130,.454,1423,1881,.757,862,2480,3342,1545,617,399,1103,1682,7534,2010-2011
DENVER NUGGETS,66,16040,2572,5404,.476,435,1311,.332,2137,4093,.522,1293,1760,.735,738,2105,2843,1581,540,330,1015,1297,6872,2011-2012
SAN ANTONIO SPURS,66,15940,2611,5463,.478,552,1405,.393,2059,4058,.507,1067,1427,.748,683,2153,2836,1528,490,293,895,1143,6841,2011-2012
OKLAHOMA CITY THUNDER,66,15990,2462,5229,.471,472,1317,.358,1990,3912,.509,1406,1744,.806,726,2157,2883,1224,498,539,1079,1352,6802,2011-2012
UTAH JAZZ,66,16165,2523,5531,.456,273,845,.323,2250,4686,.480,1258,1668,.754,861,2055,2916,1439,545,385,936,1441,6577,2011-2012
MILWAUKEE BUCKS,66,15865,2502,5652,.443,436,1265,.345,2066,4387,.471,1095,1415,.774,820,1983,2803,1550,548,335,929,1273,6535,2011-2012
SACRAMENTO KINGS,66,15915,2490,5712,.436,411,1301,.316,2079,4411,.471,1127,1532,.736,882,1947,2829,1271,561,323,952,1287,6518,2011-2012
MIAMI HEAT,66,16040,2446,5212,.469,370,1030,.359,2076,4182,.496,1238,1598,.775,686,2060,2746,1317,585,355,1002,1282,6500,2011-2012
PHOENIX SUNS,66,15840,2495,5445,.458,444,1295,.343,2051,4150,.494,1058,1397,.757,717,2035,2752,1486,431,366,928,1233,6492,2011-2012
HOUSTON ROCKETS,66,16065,2489,5543,.449,478,1330,.359,2011,4213,.477,1018,1301,.782,769,2014,2783,1404,496,319,955,1347,6474,2011-2012
MINNESOTA TIMBERWOLVES,66,15940,2355,5434,.433,473,1423,.332,1882,4011,.469,1281,1662,.771,797,2089,2886,1290,436,293,1001,1212,6464,2011-2012
NEW YORK KNICKS,66,15940,2365,5335,.443,517,1538,.336,1848,3797,.487,1211,1634,.741,743,2012,2755,1328,622,276,1056,1391,6458,2011-2012
GOLDEN STATE WARRIORS,66,15915,2489,5443,.457,524,1351,.388,1965,4092,.480,951,1235,.770,640,1947,2587,1470,528,362,915,1410,6453,2011-2012
INDIANA PACERS,66,15990,2354,5375,.438,392,1064,.368,1962,4311,.455,1349,1724,.782,826,2070,2896,1228,523,357,925,1430,6449,2011-2012
LOS ANGELES CLIPPERS,66,15965,2439,5366,.455,514,1441,.357,1925,3925,.490,1046,1538,.680,800,1943,2743,1385,556,315,879,1399,6438,2011-2012
LOS ANGELES LAKERS,66,16065,2429,5319,.457,362,1112,.326,2067,4207,.491,1202,1589,.756,799,2251,3050,1485,390,351,997,1109,6422,2011-2012
PORTLAND TRAIL BLAZERS,66,15965,2402,5417,.443,478,1382,.346,1924,4035,.477,1133,1423,.796,735,1949,2684,1349,528,322,935,1251,6415,2011-2012
ATLANTA HAWKS,66,16165,2429,5348,.454,492,1330,.370,1937,4018,.482,1025,1385,.740,652,2066,2718,1481,536,303,921,1178,6375,2011-2012
CHICAGO BULLS,66,15940,2467,5462,.452,419,1117,.375,2048,4345,.471,1006,1394,.722,915,2165,3080,1527,456,388,923,1139,6359,2011-2012
DALLAS MAVERICKS,66,16065,2398,5412,.443,497,1464,.339,1901,3948,.482,1029,1334,.771,665,2157,2822,1380,565,337,926,1226,6322,2011-2012
MEMPHIS GRIZZLIES,66,15940,2425,5422,.447,277,849,.326,2148,4573,.470,1142,1504,.759,831,1944,2775,1290,631,345,955,1316,6269,2011-2012
ORLANDO MAGIC,66,15965,2275,5162,.441,670,1785,.375,1605,3377,.475,995,1508,.660,742,2060,2802,1321,451,275,984,1168,6215,2011-2012
WASHINGTON WIZARDS,66,15865,2414,5475,.441,344,1075,.320,2070,4400,.470,1008,1386,.727,775,1975,2750,1262,527,417,1008,1405,6180,2011-2012
PHILADELPHIA 76ERS,66,15915,2471,5516,.448,349,963,.362,2122,4553,.466,889,1198,.742,704,2144,2848,1453,526,340,738,1157,6180,2011-2012
NEW JERSEY NETS,66,15890,2262,5320,.425,507,1481,.342,1755,3839,.457,1113,1433,.777,783,1879,2662,1311,493,260,995,1268,6144,2011-2012
CLEVELAND CAVALIERS,66,15965,2261,5360,.422,440,1273,.346,1821,4087,.446,1178,1645,.716,841,1949,2790,1308,466,262,1017,1317,6140,2011-2012
BOSTON CELTICS,66,15940,2341,5086,.460,363,988,.367,1978,4098,.483,1017,1308,.778,509,2051,2560,1557,498,362,979,1315,6062,2011-2012
DETROIT PISTONS,66,15965,2291,5232,.438,317,916,.346,1974,4316,.457,1098,1461,.752,775,1882,2657,1232,460,278,1033,1293,5997,2011-2012
TORONTO RAPTORS,66,15965,2268,5154,.440,365,1075,.340,1903,4079,.467,1085,1410,.770,697,2074,2771,1382,429,321,1001,1532,5986,2011-2012
NEW ORLEANS HORNETS,66,15940,2300,5103,.451,259,777,.333,2041,4326,.472,1057,1397,.757,724,1991,2715,1368,488,316,1024,1324,5916,2011-2012
CHARLOTTE BOBCATS,66,15890,2193,5293,.414,263,892,.295,1930,4401,.439,1090,1462,.746,677,1894,2571,1326,397,361,957,1249,5739,2011-2012
DENVER NUGGETS,82,19905,3339,6983,.478,521,1518,.343,2818,5465,.516,1505,2148,.701,1092,2601,3693,2002,762,533,1253,1682,8704,2012-2013
HOUSTON ROCKETS,82,19780,3124,6782,.461,867,2369,.366,2257,4413,.511,1573,2087,.754,909,2652,3561,1902,679,359,1348,1662,8688,2012-2013
OKLAHOMA CITY THUNDER,82,19830,3126,6504,.481,598,1588,.377,2528,4916,.514,1819,2196,.828,854,2725,3579,1753,679,624,1253,1654,8669,2012-2013
SAN ANTONIO SPURS,82,19880,3210,6675,.481,663,1764,.376,2547,4911,.519,1365,1725,.791,666,2721,3387,2058,695,446,1206,1427,8448,2012-2013
MIAMI HEAT,82,19880,3148,6348,.496,717,1809,.396,2431,4539,.536,1423,1887,.754,676,2490,3166,1890,710,441,1143,1533,8436,2012-2013
LOS ANGELES LAKERS,82,19755,3041,6640,.458,715,2015,.355,2326,4625,.503,1584,2289,.692,942,2732,3674,1818,576,429,1232,1467,8381,2012-2013
GOLDEN STATE WARRIORS,82,19805,3130,6840,.458,658,1632,.403,2472,5208,.475,1378,1744,.790,885,2801,3686,1845,567,346,1236,1753,8296,2012-2013
DALLAS MAVERICKS,82,19980,3182,6892,.462,606,1628,.372,2576,5264,.489,1323,1669,.793,767,2670,3437,1906,648,454,1144,1698,8293,2012-2013
LOS ANGELES CLIPPERS,82,19730,3160,6608,.478,627,1752,.358,2533,4856,.522,1342,1888,.711,938,2475,3413,1958,784,461,1197,1716,8289,2012-2013
SACRAMENTO KINGS,82,19830,3086,6904,.447,610,1681,.363,2476,5223,.474,1437,1869,.769,943,2385,3328,1708,671,342,1199,1717,8219,2012-2013
NEW YORK KNICKS,82,19730,2996,6689,.448,891,2371,.376,2105,4318,.487,1313,1729,.759,890,2436,3326,1579,672,294,988,1650,8196,2012-2013
MILWAUKEE BUCKS,82,19830,3128,7197,.435,601,1670,.360,2527,5527,.457,1251,1700,.736,1068,2537,3605,1876,685,550,1156,1554,8108,2012-2013
UTAH JAZZ,82,19880,3046,6710,.454,507,1385,.366,2539,5325,.477,1439,1883,.764,989,2457,3446,1859,690,515,1210,1750,8038,2012-2013
ATLANTA HAWKS,82,19855,3084,6644,.464,706,1901,.371,2378,4743,.501,1158,1619,.715,758,2593,3351,2007,664,369,1219,1473,8032,2012-2013
PORTLAND TRAIL BLAZERS,82,19855,3009,6715,.448,673,1904,.353,2336,4811,.486,1304,1680,.776,874,2474,3348,1784,538,353,1203,1518,7995,2012-2013
TORONTO RAPTORS,82,19980,2979,6685,.446,571,1665,.343,2408,5020,.480,1442,1831,.788,871,2426,3297,1765,595,392,1124,1836,7971,2012-2013
BROOKLYN NETS,82,19855,2942,6544,.450,628,1760,.357,2314,4784,.484,1432,1958,.731,1047,2460,3507,1668,599,391,1206,1500,7944,2012-2013
CLEVELAND CAVALIERS,82,19730,2993,6901,.434,547,1581,.346,2446,5320,.460,1380,1826,.756,1004,2359,3363,1694,647,334,1149,1737,7913,2012-2013
MINNESOTA TIMBERWOLVES,82,19730,2943,6702,.439,450,1475,.305,2493,5227,.477,1515,2042,.742,973,2473,3446,1836,700,387,1214,1509,7851,2012-2013
BOSTON CELTICS,81,19840,3001,6459,.465,498,1390,.358,2503,5069,.494,1318,1698,.776,654,2533,3187,1843,667,365,1181,1717,7818,2012-2013
PHOENIX SUNS,82,19805,3061,6917,.443,480,1455,.330,2581,5462,.473,1203,1618,.744,959,2454,3413,1855,659,434,1278,1688,7805,2012-2013
DETROIT PISTONS,82,19805,2979,6638,.449,513,1440,.356,2466,5198,.474,1307,1870,.699,991,2463,3454,1742,574,400,1241,1623,7778,2012-2013
ORLANDO MAGIC,82,19780,3093,6904,.448,506,1537,.329,2587,5367,.482,1026,1359,.755,890,2612,3502,1871,528,358,1191,1591,7718,2012-2013
NEW ORLEANS HORNETS,82,19780,2955,6589,.448,535,1474,.363,2420,5115,.473,1269,1636,.776,988,2426,3414,1721,520,440,1193,1673,7714,2012-2013
INDIANA PACERS,81,19590,2845,6525,.436,555,1599,.347,2290,4926,.465,1429,1915,.746,1043,2671,3714,1645,580,513,1227,1623,7674,2012-2013
CHARLOTTE BOBCATS,82,19805,2823,6649,.425,469,1399,.335,2354,5250,.448,1546,2060,.750,917,2389,3306,1587,591,479,1153,1561,7661,2012-2013
MEMPHIS GRIZZLIES,82,19805,2964,6679,.444,382,1107,.345,2582,5572,.463,1349,1746,.773,1059,2445,3504,1715,703,436,1144,1660,7659,2012-2013
WASHINGTON WIZARDS,82,19855,2910,6693,.435,545,1495,.365,2365,5198,.455,1279,1746,.733,887,2652,3539,1775,598,376,1238,1681,7644,2012-2013
CHICAGO BULLS,82,19830,2926,6698,.437,446,1265,.353,2480,5433,.456,1343,1738,.773,1026,2514,3540,1886,588,417,1171,1617,7641,2012-2013
PHILADELPHIA 76ERS,82,19755,3059,6895,.444,518,1438,.360,2541,5457,.466,1004,1377,.729,896,2493,3389,1867,609,384,1070,1505,7640,2012-2013
LOS ANGELES CLIPPERS,82,19755,3208,6761,.474,693,1966,.352,2515,4795,.525,1741,2384,.730,858,2668,3526,2016,703,397,1136,1767,8850,2013-2014
HOUSTON ROCKETS,82,19830,3118,6603,.472,779,2179,.358,2339,4424,.529,1814,2549,.712,920,2797,3717,1755,621,461,1323,1676,8829,2013-2014
MINNESOTA TIMBERWOLVES,82,19855,3189,7175,.444,600,1757,.341,2589,5418,.478,1790,2301,.778,1024,2644,3668,1963,718,297,1142,1504,8768,2013-2014
PORTLAND TRAIL BLAZERS,82,19855,3207,7134,.450,770,2071,.372,2437,5063,.481,1569,1926,.815,1022,2786,3808,1904,454,387,1125,1576,8753,2013-2014
OKLAHOMA CITY THUNDER,82,19805,3194,6782,.471,664,1839,.361,2530,4943,.512,1653,2052,.806,887,2781,3668,1794,678,501,1256,1858,8705,2013-2014
SAN ANTONIO SPURS,82,19755,3326,6844,.486,698,1757,.397,2628,5087,.517,1289,1642,.785,762,2786,3548,2064,604,420,1180,1495,8639,2013-2014
PHOENIX SUNS,82,19755,3172,6845,.463,765,2055,.372,2407,4790,.503,1520,2004,.758,928,2601,3529,1563,688,374,1258,1798,8629,2013-2014
DALLAS MAVERICKS,82,19830,3249,6858,.474,721,1877,.384,2528,4981,.508,1378,1733,.795,840,2514,3354,1935,704,356,1110,1636,8597,2013-2014
DENVER NUGGETS,82,19755,3147,7042,.447,702,1959,.358,2445,5083,.481,1563,2154,.726,1009,2717,3726,1838,615,459,1305,1890,8559,2013-2014
GOLDEN STATE WARRIORS,82,19830,3236,7005,.462,774,2037,.380,2462,4968,.496,1303,1731,.753,896,2819,3715,1912,642,407,1247,1784,8549,2013-2014
LOS ANGELES LAKERS,82,19705,3139,6980,.450,774,2032,.381,2365,4948,.478,1390,1835,.757,745,2620,3365,2006,611,446,1239,1627,8442,2013-2014
MIAMI HEAT,82,19880,3142,6272,.501,665,1829,.364,2477,4443,.558,1431,1884,.760,627,2397,3024,1847,732,367,1212,1596,8380,2013-2014
TORONTO RAPTORS,82,19955,2992,6718,.445,713,1917,.372,2279,4801,.475,1608,2055,.782,935,2552,3487,1737,577,343,1159,1882,8305,2013-2014
DETROIT PISTONS,82,19780,3182,7124,.447,507,1580,.321,2675,5544,.483,1415,2111,.670,1196,2525,3721,1714,687,395,1193,1666,8286,2013-2014
ATLANTA HAWKS,82,19830,3061,6688,.458,768,2116,.363,2293,4572,.502,1392,1782,.781,713,2565,3278,2041,680,326,1251,1577,8282,2013-2014
WASHINGTON WIZARDS,82,20055,3177,6920,.459,647,1704,.380,2530,5216,.485,1253,1715,.731,886,2573,3459,1909,668,377,1204,1675,8254,2013-2014
SACRAMENTO KINGS,82,19830,3026,6766,.447,491,1475,.333,2535,5291,.479,1698,2237,.759,990,2656,3646,1547,587,318,1249,1849,8241,2013-2014
NEW ORLEANS PELICANS,82,19855,3101,6761,.459,486,1303,.373,2615,5458,.479,1489,1936,.769,933,2486,3419,1745,647,523,1129,1857,8177,2013-2014
PHILADELPHIA 76ERS,82,19855,3108,7150,.435,577,1847,.312,2531,5303,.477,1362,1918,.710,949,2556,3505,1791,765,330,1384,1844,8155,2013-2014
NEW YORK KNICKS,82,19855,3027,6739,.449,759,2038,.372,2268,4701,.482,1271,1670,.761,870,2437,3307,1641,631,367,1063,1815,8084,2013-2014
BROOKLYN NETS,82,19880,2931,6391,.459,709,1922,.369,2222,4469,.497,1508,2002,.753,721,2407,3128,1714,705,311,1191,1777,8079,2013-2014
CLEVELAND CAVALIERS,82,19930,3036,6955,.437,584,1640,.356,2452,5315,.461,1398,1861,.751,989,2629,3618,1738,579,304,1163,1640,8054,2013-2014
CHARLOTTE BOBCATS,82,19905,2976,6730,.442,516,1471,.351,2460,5259,.468,1474,2000,.737,776,2724,3500,1778,499,421,1010,1493,7942,2013-2014
INDIANA PACERS,82,19780,2949,6573,.449,550,1542,.357,2399,5031,.477,1485,1907,.779,834,2831,3665,1651,550,446,1237,1675,7933,2013-2014
ORLANDO MAGIC,82,19955,3022,6784,.445,563,1596,.353,2459,5188,.474,1307,1714,.763,794,2654,3448,1726,630,350,1222,1678,7914,2013-2014
BOSTON CELTICS,82,19730,2996,6883,.435,575,1729,.333,2421,5154,.470,1325,1706,.777,980,2505,3485,1726,584,343,1261,1743,7892,2013-2014
MEMPHIS GRIZZLIES,82,19805,3122,6723,.464,405,1147,.353,2717,5576,.487,1235,1666,.741,950,2526,3476,1792,631,375,1124,1568,7884,2013-2014
MILWAUKEE BUCKS,82,19880,2952,6737,.438,548,1553,.353,2404,5184,.464,1377,1843,.747,971,2399,3370,1760,541,403,1238,1713,7829,2013-2014
UTAH JAZZ,82,19780,2951,6652,.444,543,1577,.344,2408,5075,.474,1346,1803,.747,904,2477,3381,1664,570,366,1200,1699,7791,2013-2014
CHICAGO BULLS,82,19930,2843,6577,.432,508,1459,.348,2335,5118,.456,1486,1908,.779,937,2683,3620,1860,594,424,1223,1565,7680,2013-2014
GOLDEN STATE WARRIORS,82,19730,3410,7137,.478,883,2217,.398,2527,4920,.514,1313,1709,.768,853,2814,3667,2248,762,496,1185,1628,9016,2014-2015
LOS ANGELES CLIPPERS,82,19730,3228,6830,.473,827,2202,.376,2401,4628,.519,1468,2067,.710,784,2711,3495,2031,640,409,1012,1749,8751,2014-2015
DALLAS MAVERICKS,82,19880,3255,7036,.463,732,2082,.352,2523,4954,.509,1386,1843,.752,858,2608,3466,1846,663,371,1062,1644,8628,2014-2015
TORONTO RAPTORS,82,19855,3108,6829,.455,726,2060,.352,2382,4769,.499,1585,2014,.787,881,2526,3407,1701,615,357,1057,1712,8527,2014-2015
OKLAHOMA CITY THUNDER,82,19830,3184,7119,.447,632,1864,.339,2552,5255,.486,1524,2020,.754,1052,2844,3896,1681,598,454,1205,1829,8524,2014-2015
HOUSTON ROCKETS,82,19805,3032,6832,.444,933,2680,.348,2099,4152,.506,1525,2133,.715,958,2624,3582,1820,777,407,1366,1803,8522,2014-2015
SAN ANTONIO SPURS,82,19955,3208,6854,.468,677,1847,.367,2531,5007,.505,1368,1754,.780,806,2772,3578,2000,657,444,1146,1564,8461,2014-2015
CLEVELAND CAVALIERS,82,19780,3089,6739,.458,826,2253,.367,2263,4486,.504,1453,1934,.751,911,2612,3523,1814,603,340,1171,1510,8457,2014-2015
PORTLAND TRAIL BLAZERS,82,19855,3175,7049,.450,807,2231,.362,2368,4818,.491,1272,1589,.801,879,2881,3760,1799,525,372,1117,1494,8429,2014-2015
ATLANTA HAWKS,82,19730,3121,6699,.466,818,2152,.380,2303,4547,.506,1349,1735,.778,715,2611,3326,2111,744,380,1167,1457,8409,2014-2015
PHOENIX SUNS,82,19880,3178,7038,.452,698,2048,.341,2480,4990,.497,1343,1767,.760,896,2643,3539,1659,700,385,1238,1744,8397,2014-2015
DENVER NUGGETS,82,19880,3099,7158,.433,660,2032,.325,2439,5126,.476,1462,1991,.734,1012,2653,3665,1788,641,367,1166,1882,8320,2014-2015
BOSTON CELTICS,82,19880,3193,7211,.443,660,2021,.327,2533,5190,.488,1266,1678,.754,910,2685,3595,2009,674,294,1133,1738,8312,2014-2015
SACRAMENTO KINGS,82,19855,3010,6617,.455,461,1350,.341,2549,5267,.484,1829,2400,.762,895,2728,3623,1667,550,324,1333,1696,8310,2014-2015
CHICAGO BULLS,82,19880,3001,6797,.442,645,1825,.353,2356,4972,.474,1618,2067,.783,959,2792,3751,1781,514,476,1145,1495,8265,2014-2015
NEW ORLEANS PELICANS,82,19780,3108,6795,.457,586,1583,.370,2522,5212,.484,1345,1790,.751,942,2621,3563,1806,553,510,1087,1530,8147,2014-2015
WASHINGTON WIZARDS,82,19955,3139,6790,.462,497,1381,.360,2642,5409,.488,1305,1758,.742,862,2801,3663,1969,601,378,1233,1707,8080,2014-2015
DETROIT PISTONS,82,19830,3041,7038,.432,703,2043,.344,2338,4995,.468,1292,1838,.703,1051,2630,3681,1771,623,383,1099,1559,8077,2014-2015
LOS ANGELES LAKERS,82,19930,3054,7020,.435,532,1546,.344,2522,5474,.461,1433,1935,.741,952,2647,3599,1715,578,366,1086,1741,8073,2014-2015
MEMPHIS GRIZZLIES,82,19905,3097,6763,.458,423,1246,.339,2674,5517,.485,1445,1869,.773,856,2634,3490,1777,700,347,1094,1567,8062,2014-2015
BROOKLYN NETS,82,19930,3069,6804,.451,541,1633,.331,2528,5171,.489,1359,1817,.748,846,2627,3473,1716,576,340,1133,1579,8038,2014-2015
MILWAUKEE BUCKS,82,19930,3083,6722,.459,545,1500,.363,2538,5222,.486,1312,1734,.757,876,2574,3450,1932,789,403,1373,1814,8023,2014-2015
MINNESOTA TIMBERWOLVES,82,19805,2986,6820,.438,406,1223,.332,2580,5597,.461,1638,2110,.776,949,2406,3355,1771,668,327,1231,1571,8016,2014-2015
INDIANA PACERS,82,19855,2998,6824,.439,612,1740,.352,2386,5084,.469,1373,1817,.756,856,2822,3678,1757,505,375,1147,1742,7981,2014-2015
ORLANDO MAGIC,82,19755,3076,6792,.453,554,1598,.347,2522,5194,.486,1141,1565,.729,822,2607,3429,1692,647,314,1221,1714,7847,2014-2015
UTAH JAZZ,82,19705,2900,6492,.447,610,1781,.343,2290,4711,.486,1391,1929,.721,988,2617,3605,1632,623,489,1256,1583,7801,2014-2015
MIAMI HEAT,82,19730,2885,6330,.456,556,1659,.335,2329,4671,.499,1438,1940,.741,747,2461,3208,1626,642,372,1214,1636,7764,2014-2015
CHARLOTTE HORNETS,82,19905,2913,6932,.420,498,1566,.318,2415,5366,.450,1397,1867,.748,820,2793,3613,1654,499,448,976,1494,7721,2014-2015
PHILADELPHIA 76ERS,82,19805,2765,6777,.408,692,2160,.320,2073,4617,.449,1320,1953,.676,978,2536,3514,1683,789,487,1453,1778,7542,2014-2015
NEW YORK KNICKS,82,19855,2882,6726,.428,560,1614,.347,2322,5112,.454,1211,1575,.769,867,2443,3310,1746,575,382,1206,1768,7535,2014-2015
GOLDEN STATE WARRIORS,82,19880,3489,7159,.487,1077,2592,.416,2412,4567,.528,1366,1790,.763,816,2972,3788,2373,689,498,1245,1701,9421,2015-2016
OKLAHOMA CITY THUNDER,82,19830,3372,7082,.476,678,1945,.349,2694,5137,.524,1616,2067,.782,1071,2916,3987,1883,603,487,1305,1691,9038,2015-2016
SACRAMENTO KINGS,82,19805,3283,7083,.464,660,1839,.359,2623,5244,.500,1514,2089,.725,868,2760,3628,2009,733,368,1326,1676,8740,2015-2016
HOUSTON ROCKETS,82,19830,3094,6847,.452,878,2533,.347,2216,4314,.514,1671,2407,.694,930,2601,3531,1821,821,430,1307,1790,8737,2015-2016
BOSTON CELTICS,82,19780,3216,7318,.439,717,2142,.335,2499,5176,.483,1520,1929,.788,950,2733,3683,1981,752,348,1127,1796,8669,2015-2016
PORTLAND TRAIL BLAZERS,82,19805,3167,7040,.450,864,2336,.370,2303,4704,.490,1424,1889,.754,948,2782,3730,1748,562,380,1200,1782,8622,2015-2016
LOS ANGELES CLIPPERS,82,19830,3141,6759,.465,797,2190,.364,2344,4569,.513,1490,2152,.692,721,2727,3448,1873,709,460,1063,1746,8569,2015-2016
CLEVELAND CAVALIERS,82,19855,3171,6888,.460,880,2428,.362,2291,4460,.514,1333,1783,.748,873,2777,3650,1861,551,317,1114,1666,8555,2015-2016
WASHINGTON WIZARDS,82,19755,3238,7033,.460,709,1983,.358,2529,5050,.501,1349,1849,.730,743,2688,3431,2005,708,323,1186,1708,8534,2015-2016
SAN ANTONIO SPURS,82,19705,3289,6797,.484,570,1518,.375,2719,5279,.515,1342,1672,.803,770,2831,3601,2010,677,485,1071,1433,8490,2015-2016
CHARLOTTE HORNETS,82,19855,3036,6922,.439,873,2410,.362,2163,4512,.479,1534,1941,.790,734,2869,3603,1778,595,438,1030,1487,8479,2015-2016
ATLANTA HAWKS,82,19830,3168,6923,.458,815,2326,.350,2353,4597,.512,1282,1638,.783,679,2772,3451,2100,747,486,1226,1570,8433,2015-2016
NEW ORLEANS PELICANS,82,19780,3153,7040,.448,702,1951,.360,2451,5089,.482,1415,1823,.776,782,2712,3494,1818,633,342,1102,1713,8423,2015-2016
TORONTO RAPTORS,82,19780,3006,6669,.451,708,1915,.370,2298,4754,.483,1702,2190,.777,836,2724,3560,1536,636,449,1073,1610,8422,2015-2016
MINNESOTA TIMBERWOLVES,82,19880,3095,6668,.464,455,1347,.338,2640,5321,.496,1753,2213,.792,821,2587,3408,1916,656,375,1231,1696,8398,2015-2016
DALLAS MAVERICKS,82,20005,3064,6900,.444,806,2342,.344,2258,4558,.495,1454,1831,.794,751,2781,3532,1813,560,306,1047,1595,8388,2015-2016
INDIANA PACERS,82,19880,3142,6985,.450,663,1889,.351,2479,5096,.486,1430,1872,.764,847,2779,3626,1741,742,391,1219,1641,8377,2015-2016
ORLANDO MAGIC,82,19905,3242,7120,.455,636,1818,.350,2606,5302,.492,1249,1649,.757,843,2709,3552,1933,673,417,1155,1701,8369,2015-2016
DETROIT PISTONS,82,19880,3111,7087,.439,740,2148,.345,2371,4939,.480,1399,2095,.668,1021,2777,3798,1594,573,304,1110,1557,8361,2015-2016
DENVER NUGGETS,82,19830,3093,7003,.442,656,1943,.338,2437,5060,.482,1513,1974,.766,941,2718,3659,1858,609,395,1202,1723,8355,2015-2016
CHICAGO BULLS,82,19905,3165,7170,.441,651,1753,.371,2514,5417,.464,1354,1720,.787,907,2889,3796,1870,495,470,1141,1545,8335,2015-2016
PHOENIX SUNS,82,19705,3051,7018,.435,738,2118,.348,2313,4900,.472,1431,1905,.751,943,2733,3676,1701,632,313,1410,1858,8271,2015-2016
MIAMI HEAT,82,19830,3150,6697,.470,498,1480,.336,2652,5217,.508,1406,1889,.744,807,2811,3618,1709,553,531,1155,1502,8204,2015-2016
MEMPHIS GRIZZLIES,82,19830,3019,6859,.440,504,1521,.331,2515,5338,.471,1584,2024,.783,916,2497,3413,1697,724,350,1090,1783,8126,2015-2016
MILWAUKEE BUCKS,82,19830,3145,6740,.467,440,1277,.345,2705,5463,.495,1392,1863,.747,858,2559,3417,1895,672,475,1247,1695,8122,2015-2016
BROOKLYN NETS,82,19755,3136,6920,.453,531,1508,.352,2605,5412,.481,1286,1699,.757,863,2614,3477,1829,627,332,1212,1476,8089,2015-2016
NEW YORK KNICKS,82,19805,3022,6886,.439,610,1762,.346,2412,5124,.471,1411,1753,.805,850,2788,3638,1682,467,466,1099,1616,8065,2015-2016
UTAH JAZZ,82,19955,2957,6593,.449,694,1956,.355,2263,4637,.488,1402,1885,.744,880,2665,3545,1555,631,425,1224,1655,8010,2015-2016
PHILADELPHIA 76ERS,82,19805,2970,6887,.431,764,2255,.339,2206,4632,.476,1284,1850,.694,777,2605,3382,1765,680,495,1343,1780,7988,2015-2016
LOS ANGELES LAKERS,82,19730,2880,6956,.414,639,2016,.317,2241,4940,.454,1583,2028,.781,878,2645,3523,1478,593,337,1124,1662,7982,2015-2016
GOLDEN STATE WARRIORS,82,19780,3532,7140,.495,982,2562,.383,2550,4578,.557,1457,1850,.788,770,2873,3643,2491,785,555,1211,1585,9503,2016-2017
HOUSTON ROCKETS,82,19780,3305,7152,.462,1181,3306,.357,2124,3846,.552,1667,2177,.766,892,2746,3638,2070,670,352,1240,1634,9458,2016-2017
DENVER NUGGETS,82,19755,3377,7194,.469,870,2365,.368,2507,4829,.519,1537,1986,.774,966,2837,3803,2077,568,323,1226,1567,9161,2016-2017
CLEVELAND CAVALIERS,82,19880,3275,6963,.470,1067,2779,.384,2208,4184,.528,1431,1913,.748,766,2821,3587,1858,539,327,1121,1486,9048,2016-2017
WASHINGTON WIZARDS,82,19855,3388,7137,.475,756,2030,.372,2632,5107,.515,1421,1812,.784,843,2671,3514,1956,693,336,1162,1745,8953,2016-2017
LOS ANGELES CLIPPERS,82,19755,3242,6820,.475,841,2245,.375,2401,4575,.525,1586,2128,.745,738,2790,3528,1848,612,347,1062,1626,8911,2016-2017
BOSTON CELTICS,82,19755,3168,6978,.454,985,2742,.359,2183,4236,.515,1536,1903,.807,744,2698,3442,2069,617,340,1088,1686,8857,2016-2017
PORTLAND TRAIL BLAZERS,82,19930,3243,7059,.459,852,2272,.375,2391,4787,.499,1513,1940,.780,830,2750,3580,1733,574,408,1126,1736,8851,2016-2017
PHOENIX SUNS,82,19830,3270,7260,.450,615,1854,.332,2655,5406,.491,1676,2159,.776,976,2712,3688,1604,673,399,1265,2030,8831,2016-2017
TORONTO RAPTORS,82,19780,3211,6918,.464,725,1996,.363,2486,4922,.505,1615,2028,.796,871,2676,3547,1517,677,400,1041,1708,8762,2016-2017
OKLAHOMA CITY THUNDER,82,19805,3237,7169,.452,692,2116,.327,2545,5053,.504,1575,2113,.745,1002,2821,3823,1721,648,408,1230,1715,8741,2016-2017
BROOKLYN NETS,82,19755,3102,6987,.444,877,2591,.338,2225,4396,.506,1592,2020,.788,721,2879,3600,1756,593,387,1356,1726,8673,2016-2017
MINNESOTA TIMBERWOLVES,82,19805,3235,6922,.467,601,1723,.349,2634,5199,.507,1586,1986,.799,938,2540,3478,1940,654,370,1150,1646,8657,2016-2017
SAN ANTONIO SPURS,82,19805,3222,6864,.469,753,1927,.391,2469,4937,.500,1440,1806,.797,821,2777,3598,1954,655,484,1101,1498,8637,2016-2017
INDIANA PACERS,82,19855,3221,6931,.465,709,1885,.376,2512,5046,.498,1467,1811,.810,742,2702,3444,1844,669,409,1130,1597,8618,2016-2017
CHARLOTTE HORNETS,82,19830,3093,7000,.442,824,2347,.351,2269,4653,.488,1591,1953,.815,721,2853,3574,1891,571,390,942,1360,8601,2016-2017
LOS ANGELES LAKERS,82,19705,3224,7164,.450,730,2110,.346,2494,5054,.493,1397,1853,.754,933,2636,3569,1716,674,320,1243,1698,8575,2016-2017
NEW ORLEANS PELICANS,82,19905,3210,7130,.450,768,2196,.350,2442,4934,.495,1368,1825,.750,703,2879,3582,1869,638,453,1054,1490,8556,2016-2017
NEW YORK KNICKS,82,19855,3244,7256,.447,704,2022,.348,2540,5234,.485,1364,1731,.788,983,2723,3706,1786,581,455,1139,1668,8556,2016-2017
MILWAUKEE BUCKS,82,19780,3182,6715,.474,720,1946,.370,2462,4769,.516,1413,1839,.768,723,2589,3312,1984,666,436,1145,1660,8497,2016-2017
MIAMI HEAT,82,19780,3202,7037,.455,808,2213,.365,2394,4824,.496,1248,1768,.706,872,2705,3577,1742,588,469,1102,1680,8460,2016-2017
ATLANTA HAWKS,82,19880,3123,6918,.451,729,2137,.341,2394,4781,.501,1484,2039,.728,842,2793,3635,1938,672,397,1294,1491,8459,2016-2017
CHICAGO BULLS,82,19780,3169,7141,.444,623,1831,.340,2546,5310,.479,1474,1848,.798,999,2797,3796,1851,643,393,1112,1455,8435,2016-2017
SACRAMENTO KINGS,82,19880,3105,6734,.461,737,1960,.376,2368,4774,.496,1483,1913,.775,715,2652,3367,1844,627,324,1201,1667,8430,2016-2017
PHILADELPHIA 76ERS,82,19830,3088,6992,.442,831,2443,.340,2257,4549,.496,1393,1806,.771,807,2706,3513,1949,692,420,1366,1793,8400,2016-2017
DETROIT PISTONS,82,19805,3269,7282,.449,631,1915,.330,2638,5367,.492,1140,1586,.719,908,2838,3746,1732,574,310,973,1467,8309,2016-2017
ORLANDO MAGIC,82,19805,3139,7133,.440,701,2139,.328,2438,4994,.488,1309,1753,.747,807,2734,3541,1820,580,396,1091,1584,8288,2016-2017
UTAH JAZZ,82,19755,3033,6515,.466,791,2128,.372,2242,4387,.511,1401,1875,.747,771,2774,3545,1651,550,410,1118,1545,8258,2016-2017
MEMPHIS GRIZZLIES,82,19905,2984,6854,.435,767,2169,.354,2217,4685,.473,1504,1918,.784,886,2621,3507,1744,653,344,1059,1840,8239,2016-2017
DALLAS MAVERICKS,82,19780,2968,6750,.440,878,2473,.355,2090,4277,.489,1215,1516,.801,647,2516,3163,1705,614,307,972,1567,8029,2016-2017
GOLDEN STATE WARRIORS,82,19730,3509,6981,.503,926,2370,.391,2583,4611,.560,1360,1668,.815,691,2877,3568,2402,656,612,1267,1607,9304,2017-2018
HOUSTON ROCKETS,82,19755,3174,6906,.460,1256,3470,.362,1918,3436,.558,1609,2061,.781,739,2825,3564,1767,699,392,1135,1597,9213,2017-2018
NEW ORLEANS PELICANS,82,19955,3500,7241,.483,837,2312,.362,2663,4929,.540,1324,1716,.772,712,2924,3636,2195,657,485,1223,1570,9161,2017-2018
TORONTO RAPTORS,82,19830,3383,7169,.472,968,2705,.358,2415,4464,.541,1422,1790,.794,800,2807,3607,1995,626,500,1095,1783,9156,2017-2018
CLEVELAND CAVALIERS,82,19730,3311,6950,.476,981,2636,.372,2330,4314,.540,1488,1909,.779,694,2761,3455,1916,582,312,1126,1524,9091,2017-2018
DENVER NUGGETS,82,19880,3338,7102,.470,940,2536,.371,2398,4566,.525,1404,1830,.767,902,2748,3650,2059,627,404,1227,1533,9020,2017-2018
PHILADELPHIA 76ERS,82,19780,3349,7098,.472,901,2445,.369,2448,4653,.526,1405,1868,.752,893,2996,3889,2221,682,420,1353,1811,9004,2017-2018
MINNESOTA TIMBERWOLVES,82,19805,3365,7063,.476,658,1845,.357,2707,5218,.519,1592,1980,.804,848,2593,3441,1861,689,345,1021,1495,8980,2017-2018
LOS ANGELES CLIPPERS,82,19705,3302,7004,.471,777,2196,.354,2525,4808,.525,1556,2095,.743,832,2766,3598,1832,628,373,1204,1638,8937,2017-2018
CHARLOTTE HORNETS,82,19780,3197,7106,.450,824,2233,.369,2373,4873,.487,1656,2216,.747,827,2901,3728,1770,559,373,1041,1409,8874,2017-2018
LOS ANGELES LAKERS,82,19905,3338,7248,.461,822,2384,.345,2516,4864,.517,1364,1910,.714,876,2927,3803,1949,633,388,1295,1736,8862,2017-2018
OKLAHOMA CITY THUNDER,82,19830,3271,7221,.453,881,2491,.354,2390,4730,.505,1421,1985,.716,1024,2671,3695,1750,743,412,1147,1653,8844,2017-2018
WASHINGTON WIZARDS,82,19855,3275,7018,.467,814,2173,.375,2461,4845,.508,1378,1786,.772,823,2713,3536,2065,645,353,1196,1746,8742,2017-2018
BROOKLYN NETS,82,19855,3136,7114,.441,1041,2924,.356,2095,4190,.500,1428,1850,.772,792,2852,3644,1941,512,390,1245,1688,8741,2017-2018
MILWAUKEE BUCKS,82,19830,3257,6807,.478,718,2024,.355,2539,4783,.531,1499,1915,.783,688,2579,3267,1905,722,443,1134,1752,8731,2017-2018
PORTLAND TRAIL BLAZERS,82,19755,3222,7132,.452,845,2308,.366,2377,4824,.493,1372,1715,.800,835,2893,3728,1599,573,423,1109,1599,8661,2017-2018
INDIANA PACERS,82,19755,3345,7083,.472,741,2010,.369,2604,5073,.513,1225,1573,.779,788,2684,3472,1819,721,340,1089,1544,8656,2017-2018
NEW YORK KNICKS,82,19830,3334,7193,.464,673,1914,.352,2661,5279,.504,1225,1557,.787,859,2752,3611,1912,552,421,1207,1682,8566,2017-2018
UTAH JAZZ,82,19755,3139,6797,.462,887,2425,.366,2252,4372,.515,1375,1766,.779,740,2807,3547,1839,708,420,1205,1608,8540,2017-2018
BOSTON CELTICS,82,19805,3141,6975,.450,939,2492,.377,2202,4483,.491,1308,1697,.771,767,2878,3645,1842,604,373,1149,1618,8529,2017-2018
PHOENIX SUNS,82,19705,3153,7141,.442,763,2286,.334,2390,4855,.492,1453,1962,.741,842,2776,3618,1743,569,370,1289,1807,8522,2017-2018
DETROIT PISTONS,82,19805,3208,7129,.450,886,2373,.373,2322,4756,.488,1207,1621,.745,830,2756,3586,1868,628,317,1103,1508,8509,2017-2018
MIAMI HEAT,82,19930,3184,6997,.455,903,2506,.360,2281,4491,.508,1209,1601,.755,763,2801,3564,1862,620,437,1179,1648,8480,2017-2018
ORLANDO MAGIC,82,19730,3182,7042,.452,844,2405,.351,2338,4637,.504,1271,1678,.757,722,2692,3414,1921,622,400,1192,1579,8479,2017-2018
ATLANTA HAWKS,82,19705,3130,7015,.446,917,2544,.360,2213,4471,.495,1298,1654,.785,743,2693,3436,1946,638,348,1276,1606,8475,2017-2018
CHICAGO BULLS,82,19855,3170,7285,.435,906,2549,.355,2264,4736,.478,1194,1574,.759,790,2873,3663,1923,626,289,1147,1571,8440,2017-2018
SAN ANTONIO SPURS,82,19730,3202,6999,.457,696,1977,.352,2506,5022,.499,1324,1715,.772,849,2777,3626,1868,628,460,1078,1408,8424,2017-2018
DALLAS MAVERICKS,82,19805,3128,7042,.444,967,2688,.360,2161,4354,.496,1167,1530,.763,666,2717,3383,1858,578,310,1008,1578,8390,2017-2018
MEMPHIS GRIZZLIES,82,19705,3013,6788,.444,758,2152,.352,2255,4636,.486,1361,1732,.786,779,2544,3323,1767,613,396,1227,1900,8145,2017-2018
SACRAMENTO KINGS,82,19755,3179,7063,.450,738,1967,.375,2441,5096,.479,1008,1371,.735,777,2578,3355,1768,643,340,1125,1639,8104,2017-2018
MILWAUKEE BUCKS,82,19780,3555,7471,.476,1105,3134,.353,2450,4337,.565,1471,1904,.773,762,3316,4078,2136,615,486,1137,1608,9686,2018-2019
GOLDEN STATE WARRIORS,82,19805,3612,7361,.491,1087,2824,.385,2525,4537,.557,1339,1672,.801,797,2990,3787,2413,625,525,1169,1757,9650,2018-2019
NEW ORLEANS PELICANS,82,19755,3581,7563,.473,842,2449,.344,2739,5114,.536,1462,1921,.761,909,2969,3878,2216,610,441,1215,1732,9466,2018-2019
PHILADELPHIA 76ERS,82,19805,3407,7233,.471,889,2474,.359,2518,4759,.529,1742,2258,.771,892,3025,3917,2207,606,432,1223,1745,9445,2018-2019
LOS ANGELES CLIPPERS,82,19830,3384,7178,.471,821,2118,.388,2563,5060,.507,1853,2340,.792,796,2936,3732,1970,561,385,1193,1913,9442,2018-2019
PORTLAND TRAIL BLAZERS,82,19855,3470,7427,.467,904,2520,.359,2566,4907,.523,1558,1914,.814,967,2968,3935,1887,546,413,1135,1669,9402,2018-2019
OKLAHOMA CITY THUNDER,82,19855,3497,7706,.454,932,2677,.348,2565,5029,.510,1461,2049,.713,1031,2911,3942,1917,766,425,1145,1839,9387,2018-2019
TORONTO RAPTORS,82,19880,3460,7305,.474,1015,2771,.366,2445,4534,.539,1449,1803,.804,786,2920,3706,2085,680,437,1150,1724,9384,2018-2019
SACRAMENTO KINGS,82,19730,3541,7637,.464,927,2455,.378,2614,5182,.504,1354,1865,.726,906,2819,3725,2083,679,363,1095,1751,9363,2018-2019
WASHINGTON WIZARDS,82,19930,3456,7387,.468,930,2731,.341,2526,4656,.543,1508,1963,.768,794,2679,3473,2154,683,379,1154,1701,9350,2018-2019
HOUSTON ROCKETS,82,19830,3218,7163,.449,1323,3721,.356,1895,3442,.551,1582,2001,.791,836,2613,3449,1741,700,405,1094,1803,9341,2018-2019
ATLANTA HAWKS,82,19855,3392,7524,.451,1067,3034,.352,2325,4490,.518,1443,1918,.752,955,2825,3780,2118,675,419,1397,1932,9294,2018-2019
MINNESOTA TIMBERWOLVES,82,19830,3413,7483,.456,827,2357,.351,2586,5126,.504,1570,1995,.787,923,2750,3673,2018,683,411,1074,1664,9223,2018-2019
BOSTON CELTICS,82,19780,3451,7423,.465,1032,2829,.365,2419,4594,.527,1282,1598,.802,804,2849,3653,2155,706,435,1052,1670,9216,2018-2019
BROOKLYN NETS,82,19980,3301,7358,.449,1047,2965,.353,2254,4393,.513,1555,2088,.745,900,2919,3819,1954,539,339,1236,1763,9204,2018-2019
LOS ANGELES LAKERS,82,19780,3491,7425,.470,847,2541,.333,2644,4884,.541,1336,1910,.699,835,2985,3820,2096,618,440,1284,1701,9165,2018-2019
UTAH JAZZ,82,19755,3314,7082,.468,993,2789,.356,2321,4293,.541,1540,2092,.736,820,2981,3801,2133,663,483,1240,1728,9161,2018-2019
SAN ANTONIO SPURS,82,19805,3468,7248,.478,812,2071,.392,2656,5177,.513,1408,1720,.819,757,2910,3667,2013,501,386,992,1487,9156,2018-2019
CHARLOTTE HORNETS,82,19830,3297,7362,.448,977,2783,.351,2320,4579,.507,1510,1895,.797,814,2778,3592,1905,591,405,1001,1550,9081,2018-2019
DENVER NUGGETS,82,19730,3439,7384,.466,903,2571,.351,2536,4813,.527,1294,1714,.755,972,2832,3804,2245,634,363,1102,1644,9075,2018-2019
DALLAS MAVERICKS,82,19780,3182,7122,.447,1022,3002,.340,2160,4120,.524,1541,2076,.742,832,2884,3716,1918,533,351,1167,1650,8927,2018-2019
INDIANA PACERS,82,19705,3390,7135,.475,779,2081,.374,2611,5054,.517,1298,1727,.752,762,2766,3528,2128,713,404,1122,1594,8857,2018-2019
PHOENIX SUNS,82,19880,3289,7164,.459,790,2400,.329,2499,4764,.525,1447,1858,.779,748,2563,3311,1957,735,418,1279,1932,8815,2018-2019
ORLANDO MAGIC,82,19780,3316,7307,.454,937,2633,.356,2379,4674,.509,1231,1575,.782,822,2902,3724,2095,543,445,1082,1526,8800,2018-2019
DETROIT PISTONS,82,19855,3185,7238,.440,993,2854,.348,2192,4384,.500,1415,1893,.747,936,2752,3688,1845,569,331,1135,1811,8778,2018-2019
MIAMI HEAT,82,19730,3251,7218,.450,928,2658,.349,2323,4560,.509,1238,1782,.695,921,2879,3800,1991,627,448,1208,1712,8668,2018-2019
CHICAGO BULLS,82,19905,3266,7205,.453,745,2123,.351,2521,5082,.496,1328,1695,.783,718,2799,3517,1796,603,351,1159,1663,8605,2018-2019
NEW YORK KNICKS,82,19780,3134,7241,.433,823,2421,.340,2311,4820,.479,1484,1956,.759,857,2811,3668,1646,557,422,1151,1713,8575,2018-2019
CLEVELAND CAVALIERS,82,19755,3189,7184,.444,847,2388,.355,2342,4796,.488,1342,1694,.792,879,2619,3498,1698,534,195,1106,1642,8567,2018-2019
MEMPHIS GRIZZLIES,82,19880,3113,6924,.450,811,2368,.342,2302,4556,.505,1453,1882,.772,723,2703,3426,1963,684,448,1147,1801,8490,2018-2019
DALLAS MAVERICKS,75,18175,3124,6772,.461,1136,3095,.367,1988,3677,.541,1392,1787,.779,791,2729,3520,1849,460,363,953,1462,8776,2019-2020
MILWAUKEE BUCKS,73,17595,3160,6638,.476,1007,2840,.355,2153,3798,.567,1336,1800,.742,691,3083,3774,1889,526,429,1102,1431,8663,2019-2020
PORTLAND TRAIL BLAZERS,74,17835,3122,6749,.463,952,2525,.377,2170,4224,.514,1312,1632,.804,754,2599,3353,1525,465,451,946,1606,8508,2019-2020
HOUSTON ROCKETS,72,17380,2936,6512,.451,1126,3261,.345,1810,3251,.557,1484,1876,.791,704,2484,3188,1557,627,371,1057,1566,8482,2019-2020
LOS ANGELES CLIPPERS,72,17380,2992,6425,.466,895,2410,.371,2097,4015,.522,1498,1894,.791,767,2664,3431,1708,511,338,1051,1594,8377,2019-2020
NEW ORLEANS PELICANS,72,17430,3065,6598,.465,982,2656,.370,2083,3942,.528,1229,1687,.729,797,2551,3348,1932,539,358,1181,1524,8341,2019-2020
PHOENIX SUNS,73,17595,3006,6429,.468,831,2320,.358,2175,4109,.529,1451,1740,.834,712,2465,3177,1987,559,290,1077,1609,8294,2019-2020
WASHINGTON WIZARDS,72,17355,2990,6544,.457,864,2345,.368,2126,4199,.506,1394,1770,.788,732,2295,3027,1801,574,309,1020,1634,8238,2019-2020
MEMPHIS GRIZZLIES,73,17570,3106,6634,.468,798,2297,.347,2308,4337,.532,1212,1589,.763,754,2643,3397,1965,576,398,1113,1546,8222,2019-2020
BOSTON CELTICS,72,17430,2971,6448,.461,905,2487,.364,2066,3961,.522,1336,1668,.801,768,2549,3317,1655,595,406,995,1553,8183,2019-2020
MIAMI HEAT,73,17745,2880,6160,.468,979,2584,.379,1901,3576,.532,1440,1840,.783,620,2619,3239,1892,547,332,1088,1501,8179,2019-2020
DENVER NUGGETS,73,17745,3069,6488,.473,801,2234,.359,2268,4254,.533,1185,1526,.777,786,2436,3222,1952,586,337,1005,1485,8124,2019-2020
TORONTO RAPTORS,72,17380,2897,6331,.458,995,2663,.374,1902,3668,.519,1329,1670,.796,685,2583,3268,1816,636,358,1067,1559,8118,2019-2020
SAN ANTONIO SPURS,71,17215,2995,6350,.472,760,2021,.376,2235,4329,.516,1348,1664,.810,640,2530,3170,1751,518,390,895,1377,8098,2019-2020
PHILADELPHIA 76ERS,73,17595,3000,6417,.468,848,2307,.368,2152,4110,.524,1236,1638,.755,764,2553,3317,1884,586,389,1037,1529,8084,2019-2020
LOS ANGELES LAKERS,71,17090,3006,6269,.480,782,2242,.349,2224,4027,.552,1260,1728,.729,757,2490,3247,1803,612,468,1077,1471,8054,2019-2020
BROOKLYN NETS,72,17480,2908,6498,.448,941,2746,.343,1967,3752,.524,1291,1732,.745,766,2683,3449,1761,464,323,1099,1510,8048,2019-2020
UTAH JAZZ,72,17355,2886,6130,.471,963,2537,.380,1923,3593,.535,1278,1641,.779,656,2577,3233,1615,438,292,1089,1468,8013,2019-2020
INDIANA PACERS,73,17620,3075,6457,.476,743,2046,.363,2332,4411,.529,1096,1393,.787,636,2489,3125,1888,543,376,967,1445,7989,2019-2020
OKLAHOMA CITY THUNDER,72,17430,2879,6156,.468,770,2171,.355,2109,3985,.529,1422,1787,.796,593,2495,3088,1562,550,353,986,1390,7950,2019-2020
SACRAMENTO KINGS,72,17455,2943,6364,.462,914,2511,.364,2029,3853,.527,1127,1464,.770,695,2372,3067,1713,556,293,1043,1595,7927,2019-2020
ORLANDO MAGIC,73,17570,2871,6468,.444,807,2354,.343,2064,4114,.502,1282,1656,.774,751,2498,3249,1747,599,396,937,1336,7831,2019-2020
ATLANTA HAWKS,67,16280,2723,6067,.449,805,2416,.333,1918,3651,.525,1237,1566,.790,661,2237,2898,1605,523,341,1086,1548,7488,2019-2020
MINNESOTA TIMBERWOLVES,64,15560,2586,5865,.441,853,2540,.336,1733,3325,.521,1223,1624,.753,675,2193,2868,1525,555,362,981,1370,7248,2019-2020
DETROIT PISTONS,66,15965,2595,5658,.459,791,2157,.367,1804,3501,.515,1097,1476,.743,644,2109,2753,1589,490,299,1008,1299,7078,2019-2020
NEW YORK KNICKS,66,15965,2638,5896,.447,631,1872,.337,2007,4024,.499,1076,1550,.694,795,2274,3069,1456,504,313,946,1464,6983,2019-2020
CLEVELAND CAVALIERS,65,15725,2619,5715,.458,727,2070,.351,1892,3645,.519,983,1296,.758,704,2172,2876,1500,447,211,1073,1188,6948,2019-2020
CHICAGO BULLS,65,15675,2573,5762,.447,793,2282,.348,1780,3480,.511,1006,1332,.755,680,2041,2721,1510,652,265,1005,1417,6945,2019-2020
GOLDEN STATE WARRIORS,65,15725,2510,5730,.438,678,2032,.334,1832,3698,.495,1214,1511,.803,647,2138,2785,1663,534,299,969,1304,6912,2019-2020
CHARLOTTE HORNETS,65,15750,2425,5586,.434,785,2231,.352,1640,3355,.489,1052,1406,.748,715,2066,2781,1549,428,268,949,1223,6687,2019-2020
